year,eff_mom,eff_dad,nbabies,naliveadults,possible_mom,possible_dad,eff_mig,parameterset,replicate,project,group,sum
1,11,11,14,612,300,312,0,1,1,ABMrun_3.1.23_b,1,626
2,86,75,108,876,430,446,0,1,1,ABMrun_3.1.23_b,1,984
3,131,116,164,806,394,412,0,1,1,ABMrun_3.1.23_b,1,970
4,170,137,210,706,359,347,0,1,1,ABMrun_3.1.23_b,1,916
5,183,132,231,646,330,316,0,1,1,ABMrun_3.1.23_b,1,877
6,173,143,229,662,331,331,0,1,1,ABMrun_3.1.23_b,1,891
7,179,133,230,654,325,329,0,1,1,ABMrun_3.1.23_b,1,884
8,177,138,225,668,337,331,0,1,1,ABMrun_3.1.23_b,1,893
9,173,141,220,680,338,342,0,1,1,ABMrun_3.1.23_b,1,900
10,185,136,230,665,328,337,0,1,1,ABMrun_3.1.23_b,1,895
11,176,142,228,661,318,343,0,1,1,ABMrun_3.1.23_b,1,889
12,180,138,231,650,324,326,0,1,1,ABMrun_3.1.23_b,1,881
13,178,138,230,656,327,329,0,1,1,ABMrun_3.1.23_b,1,886
14,171,125,225,677,345,332,0,1,1,ABMrun_3.1.23_b,1,902
15,176,126,224,673,363,310,0,1,1,ABMrun_3.1.23_b,1,897
16,187,141,234,632,326,306,0,1,1,ABMrun_3.1.23_b,1,866
17,186,142,232,654,316,338,0,1,1,ABMrun_3.1.23_b,1,886
18,183,138,230,651,310,341,0,1,1,ABMrun_3.1.23_b,1,881
19,187,144,235,633,308,325,0,1,1,ABMrun_3.1.23_b,1,868
20,192,151,234,636,306,330,0,1,1,ABMrun_3.1.23_b,1,870
21,185,146,232,654,314,340,0,1,1,ABMrun_3.1.23_b,1,886
22,186,135,231,659,319,340,0,1,1,ABMrun_3.1.23_b,1,890
23,175,137,233,647,304,343,0,1,1,ABMrun_3.1.23_b,1,880
24,189,145,239,623,294,329,0,1,1,ABMrun_3.1.23_b,1,862
25,192,140,238,621,319,302,0,1,1,ABMrun_3.1.23_b,1,859
26,171,139,215,704,344,360,0,1,1,ABMrun_3.1.23_b,1,919
27,171,133,220,687,348,339,0,1,1,ABMrun_3.1.23_b,1,907
28,182,129,232,663,343,320,0,1,1,ABMrun_3.1.23_b,1,895
29,182,140,231,659,329,330,0,1,1,ABMrun_3.1.23_b,1,890
30,173,142,227,668,327,341,0,1,1,ABMrun_3.1.23_b,1,895
31,182,135,233,646,312,334,0,1,1,ABMrun_3.1.23_b,1,879
32,176,146,227,661,316,345,0,1,1,ABMrun_3.1.23_b,1,888
33,178,137,225,669,330,339,0,1,1,ABMrun_3.1.23_b,1,894
34,181,141,230,662,335,327,0,1,1,ABMrun_3.1.23_b,1,892
35,182,138,231,658,334,324,0,1,1,ABMrun_3.1.23_b,1,889
36,181,145,228,664,345,319,0,1,1,ABMrun_3.1.23_b,1,892
37,175,145,224,678,353,325,0,1,1,ABMrun_3.1.23_b,1,902
38,172,137,226,665,339,326,0,1,1,ABMrun_3.1.23_b,1,891
39,180,140,225,670,333,337,0,1,1,ABMrun_3.1.23_b,1,895
40,186,143,232,638,328,310,0,1,1,ABMrun_3.1.23_b,1,870
41,173,136,230,649,326,323,0,1,1,ABMrun_3.1.23_b,1,879
42,182,144,232,656,329,327,0,1,1,ABMrun_3.1.23_b,1,888
43,179,132,230,656,328,328,0,1,1,ABMrun_3.1.23_b,1,886
44,186,145,234,641,326,315,0,1,1,ABMrun_3.1.23_b,1,875
45,176,131,229,667,322,345,0,1,1,ABMrun_3.1.23_b,1,896
46,167,132,223,676,325,351,0,1,1,ABMrun_3.1.23_b,1,899
47,175,146,225,670,322,348,0,1,1,ABMrun_3.1.23_b,1,895
48,171,133,225,670,327,343,0,1,1,ABMrun_3.1.23_b,1,895
49,189,137,232,661,332,329,0,1,1,ABMrun_3.1.23_b,1,893
50,175,141,221,677,354,323,0,1,1,ABMrun_3.1.23_b,1,898
51,166,131,212,702,345,357,0,1,1,ABMrun_3.1.23_b,1,914
52,169,142,227,664,320,344,0,1,1,ABMrun_3.1.23_b,1,891
53,174,143,233,649,310,339,0,1,1,ABMrun_3.1.23_b,1,882
54,178,134,229,658,304,354,0,1,1,ABMrun_3.1.23_b,1,887
55,180,145,224,674,312,362,0,1,1,ABMrun_3.1.23_b,1,898
56,183,137,231,653,300,353,0,1,1,ABMrun_3.1.23_b,1,884
57,175,138,236,645,305,340,0,1,1,ABMrun_3.1.23_b,1,881
58,177,140,230,662,318,344,0,1,1,ABMrun_3.1.23_b,1,892
59,177,135,227,664,320,344,0,1,1,ABMrun_3.1.23_b,1,891
60,185,143,233,638,305,333,0,1,1,ABMrun_3.1.23_b,1,871
61,186,140,226,662,322,340,0,1,1,ABMrun_3.1.23_b,1,888
62,180,131,234,643,331,312,0,1,1,ABMrun_3.1.23_b,1,877
63,174,132,224,674,349,325,0,1,1,ABMrun_3.1.23_b,1,898
64,169,130,223,677,347,330,0,1,1,ABMrun_3.1.23_b,1,900
65,175,136,220,684,359,325,0,1,1,ABMrun_3.1.23_b,1,904
66,173,140,225,666,342,324,0,1,1,ABMrun_3.1.23_b,1,891
67,184,138,232,661,332,329,0,1,1,ABMrun_3.1.23_b,1,893
68,177,140,231,662,329,333,0,1,1,ABMrun_3.1.23_b,1,893
69,188,139,235,635,320,315,0,1,1,ABMrun_3.1.23_b,1,870
70,178,130,232,642,325,317,0,1,1,ABMrun_3.1.23_b,1,874
71,179,138,227,662,331,331,0,1,1,ABMrun_3.1.23_b,1,889
72,184,140,235,653,331,322,0,1,1,ABMrun_3.1.23_b,1,888
73,177,127,226,673,356,317,0,1,1,ABMrun_3.1.23_b,1,899
74,183,138,229,655,337,318,0,1,1,ABMrun_3.1.23_b,1,884
75,171,129,223,684,340,344,0,1,1,ABMrun_3.1.23_b,1,907
76,166,125,209,723,348,375,0,1,1,ABMrun_3.1.23_b,1,932
77,177,142,230,659,312,347,0,1,1,ABMrun_3.1.23_b,1,889
78,179,138,230,652,295,357,0,1,1,ABMrun_3.1.23_b,1,882
79,184,144,232,637,304,333,0,1,1,ABMrun_3.1.23_b,1,869
80,178,137,233,648,313,335,0,1,1,ABMrun_3.1.23_b,1,881
81,174,139,228,660,339,321,0,1,1,ABMrun_3.1.23_b,1,888
82,182,135,224,659,341,318,0,1,1,ABMrun_3.1.23_b,1,883
83,170,129,221,678,353,325,0,1,1,ABMrun_3.1.23_b,1,899
84,172,130,222,678,342,336,0,1,1,ABMrun_3.1.23_b,1,900
85,180,133,233,643,334,309,0,1,1,ABMrun_3.1.23_b,1,876
86,180,143,227,665,334,331,0,1,1,ABMrun_3.1.23_b,1,892
87,176,137,228,656,337,319,0,1,1,ABMrun_3.1.23_b,1,884
88,184,137,231,662,347,315,0,1,1,ABMrun_3.1.23_b,1,893
89,171,131,219,684,359,325,0,1,1,ABMrun_3.1.23_b,1,903
90,174,125,229,668,337,331,0,1,1,ABMrun_3.1.23_b,1,897
91,171,136,222,680,329,351,0,1,1,ABMrun_3.1.23_b,1,902
92,180,144,230,655,303,352,0,1,1,ABMrun_3.1.23_b,1,885
93,177,145,232,647,307,340,0,1,1,ABMrun_3.1.23_b,1,879
94,176,135,225,668,322,346,0,1,1,ABMrun_3.1.23_b,1,893
95,173,135,225,666,335,331,0,1,1,ABMrun_3.1.23_b,1,891
96,173,126,221,679,354,325,0,1,1,ABMrun_3.1.23_b,1,900
97,176,134,231,642,330,312,0,1,1,ABMrun_3.1.23_b,1,873
98,175,136,225,663,334,329,0,1,1,ABMrun_3.1.23_b,1,888
99,170,131,213,697,353,344,0,1,1,ABMrun_3.1.23_b,1,910
100,166,137,214,667,337,330,0,1,1,ABMrun_3.1.23_b,1,881
101,147,118,195,683,343,340,0,1,1,ABMrun_3.1.23_b,1,878
102,156,125,206,601,291,310,0,1,1,ABMrun_3.1.23_b,1,807
103,158,117,200,593,283,310,0,1,1,ABMrun_3.1.23_b,1,793
104,151,114,194,570,279,291,0,1,1,ABMrun_3.1.23_b,1,764
105,139,108,178,565,283,282,0,1,1,ABMrun_3.1.23_b,1,743
106,129,101,163,571,290,281,0,1,1,ABMrun_3.1.23_b,1,734
107,126,104,160,535,267,268,0,1,1,ABMrun_3.1.23_b,1,695
108,125,107,154,517,254,263,0,1,1,ABMrun_3.1.23_b,1,671
109,123,97,157,479,243,236,0,1,1,ABMrun_3.1.23_b,1,636
110,59,49,79,470,238,232,0,1,1,ABMrun_3.1.23_b,1,549
111,68,59,86,406,204,202,0,1,1,ABMrun_3.1.23_b,1,492
112,66,50,86,355,184,171,0,1,1,ABMrun_3.1.23_b,1,441
113,69,54,84,287,149,138,0,1,1,ABMrun_3.1.23_b,1,371
114,61,48,82,256,132,124,0,1,1,ABMrun_3.1.23_b,1,338
115,58,46,79,239,115,124,0,1,1,ABMrun_3.1.23_b,1,318
116,61,49,77,232,109,123,0,1,1,ABMrun_3.1.23_b,1,309
117,59,46,78,241,107,134,0,1,1,ABMrun_3.1.23_b,1,319
118,62,50,74,216,95,121,0,1,1,ABMrun_3.1.23_b,1,290
119,58,52,75,217,100,117,0,1,1,ABMrun_3.1.23_b,1,292
120,57,46,77,230,110,120,0,1,1,ABMrun_3.1.23_b,1,307
121,61,53,77,238,110,128,0,1,1,ABMrun_3.1.23_b,1,315
122,56,46,74,212,90,122,0,1,1,ABMrun_3.1.23_b,1,286
123,53,43,73,221,98,123,0,1,1,ABMrun_3.1.23_b,1,294
124,55,46,73,215,98,117,0,1,1,ABMrun_3.1.23_b,1,288
125,60,49,75,219,90,129,0,1,1,ABMrun_3.1.23_b,1,294
126,58,47,76,234,102,132,0,1,1,ABMrun_3.1.23_b,1,310
127,57,43,76,227,108,119,0,1,1,ABMrun_3.1.23_b,1,303
128,61,53,76,219,104,115,0,1,1,ABMrun_3.1.23_b,1,295
129,55,45,72,207,101,106,0,1,1,ABMrun_3.1.23_b,1,279
130,57,40,74,221,109,112,0,1,1,ABMrun_3.1.23_b,1,295
131,61,45,77,225,97,128,0,1,1,ABMrun_3.1.23_b,1,302
132,60,45,76,230,107,123,0,1,1,ABMrun_3.1.23_b,1,306
133,62,51,74,226,104,122,0,1,1,ABMrun_3.1.23_b,1,300
134,60,48,76,232,104,128,0,1,1,ABMrun_3.1.23_b,1,308
135,61,48,75,213,106,107,0,1,1,ABMrun_3.1.23_b,1,288
136,56,44,72,213,92,121,0,1,1,ABMrun_3.1.23_b,1,285
137,55,42,72,207,97,110,0,1,1,ABMrun_3.1.23_b,1,279
138,57,47,74,210,91,119,0,1,1,ABMrun_3.1.23_b,1,284
139,58,46,74,212,86,126,0,1,1,ABMrun_3.1.23_b,1,286
140,61,47,74,215,88,127,0,1,1,ABMrun_3.1.23_b,1,289
141,60,46,75,218,95,123,0,1,1,ABMrun_3.1.23_b,1,293
142,57,49,74,213,101,112,0,1,1,ABMrun_3.1.23_b,1,287
143,54,41,73,208,102,106,0,1,1,ABMrun_3.1.23_b,1,281
144,60,40,77,231,119,112,0,1,1,ABMrun_3.1.23_b,1,308
145,59,47,74,215,114,101,0,1,1,ABMrun_3.1.23_b,1,289
146,52,42,68,194,101,93,0,1,1,ABMrun_3.1.23_b,1,262
147,57,44,72,203,103,100,0,1,1,ABMrun_3.1.23_b,1,275
148,59,46,75,206,102,104,0,1,1,ABMrun_3.1.23_b,1,281
149,60,39,78,233,118,115,0,1,1,ABMrun_3.1.23_b,1,311
150,64,49,78,240,120,120,0,1,1,ABMrun_3.1.23_b,1,318
151,137,91,184,338,165,173,58,1,1,ABMrun_3.1.23_b,1,522
152,152,108,189,394,197,197,36,1,1,ABMrun_3.1.23_b,1,583
153,158,114,197,452,203,249,16,1,1,ABMrun_3.1.23_b,1,649
154,143,104,194,514,255,259,5,1,1,ABMrun_3.1.23_b,1,708
155,155,115,199,545,273,272,3,1,1,ABMrun_3.1.23_b,1,744
156,162,122,211,540,267,273,0,1,1,ABMrun_3.1.23_b,1,751
157,165,122,209,589,291,298,0,1,1,ABMrun_3.1.23_b,1,798
158,175,126,221,589,292,297,0,1,1,ABMrun_3.1.23_b,1,810
159,180,133,228,615,282,333,0,1,1,ABMrun_3.1.23_b,1,843
160,185,141,239,615,285,330,0,1,1,ABMrun_3.1.23_b,1,854
161,177,143,234,638,296,342,0,1,1,ABMrun_3.1.23_b,1,872
162,178,145,226,666,318,348,0,1,1,ABMrun_3.1.23_b,1,892
163,172,135,219,687,330,357,0,1,1,ABMrun_3.1.23_b,1,906
164,166,134,212,699,338,361,0,1,1,ABMrun_3.1.23_b,1,911
165,181,148,231,641,302,339,0,1,1,ABMrun_3.1.23_b,1,872
166,183,136,225,666,336,330,0,1,1,ABMrun_3.1.23_b,1,891
167,171,134,220,679,342,337,0,1,1,ABMrun_3.1.23_b,1,899
168,184,144,231,644,293,351,0,1,1,ABMrun_3.1.23_b,1,875
169,176,138,226,669,315,354,0,1,1,ABMrun_3.1.23_b,1,895
170,176,137,232,632,315,317,0,1,1,ABMrun_3.1.23_b,1,864
171,178,137,232,650,326,324,0,1,1,ABMrun_3.1.23_b,1,882
172,176,136,230,657,322,335,0,1,1,ABMrun_3.1.23_b,1,887
173,181,141,230,649,314,335,0,1,1,ABMrun_3.1.23_b,1,879
174,169,135,218,679,317,362,0,1,1,ABMrun_3.1.23_b,1,897
175,164,137,221,671,321,350,0,1,1,ABMrun_3.1.23_b,1,892
176,157,129,201,727,355,372,0,1,1,ABMrun_3.1.23_b,1,928
177,184,133,230,647,323,324,0,1,1,ABMrun_3.1.23_b,1,877
178,176,140,225,662,324,338,0,1,1,ABMrun_3.1.23_b,1,887
179,172,139,226,666,331,335,0,1,1,ABMrun_3.1.23_b,1,892
180,173,134,221,680,335,345,0,1,1,ABMrun_3.1.23_b,1,901
181,176,140,229,654,316,338,0,1,1,ABMrun_3.1.23_b,1,883
182,182,140,227,668,332,336,0,1,1,ABMrun_3.1.23_b,1,895
183,177,137,226,659,327,332,0,1,1,ABMrun_3.1.23_b,1,885
184,188,143,231,649,325,324,0,1,1,ABMrun_3.1.23_b,1,880
185,169,128,228,661,361,300,0,1,1,ABMrun_3.1.23_b,1,889
186,171,142,223,675,341,334,0,1,1,ABMrun_3.1.23_b,1,898
187,174,135,221,674,335,339,0,1,1,ABMrun_3.1.23_b,1,895
188,173,130,224,671,344,327,0,1,1,ABMrun_3.1.23_b,1,895
189,179,132,229,654,343,311,0,1,1,ABMrun_3.1.23_b,1,883
190,176,138,225,667,345,322,0,1,1,ABMrun_3.1.23_b,1,892
191,172,133,224,671,355,316,0,1,1,ABMrun_3.1.23_b,1,895
192,177,137,227,658,340,318,0,1,1,ABMrun_3.1.23_b,1,885
193,170,130,224,669,330,339,0,1,1,ABMrun_3.1.23_b,1,893
194,166,132,218,685,327,358,0,1,1,ABMrun_3.1.23_b,1,903
195,181,136,229,657,310,347,0,1,1,ABMrun_3.1.23_b,1,886
196,180,138,226,657,330,327,0,1,1,ABMrun_3.1.23_b,1,883
197,178,137,223,666,335,331,0,1,1,ABMrun_3.1.23_b,1,889
198,170,136,222,673,330,343,0,1,1,ABMrun_3.1.23_b,1,895
199,175,130,226,662,322,340,0,1,1,ABMrun_3.1.23_b,1,888
200,171,138,219,683,332,351,0,1,1,ABMrun_3.1.23_b,1,902
201,159,127,205,723,343,380,0,1,1,ABMrun_3.1.23_b,1,928
202,165,141,211,698,316,382,0,1,1,ABMrun_3.1.23_b,1,909
203,184,147,234,642,300,342,0,1,1,ABMrun_3.1.23_b,1,876
204,175,137,228,658,310,348,0,1,1,ABMrun_3.1.23_b,1,886
205,176,143,228,654,327,327,0,1,1,ABMrun_3.1.23_b,1,882
206,166,128,219,685,353,332,0,1,1,ABMrun_3.1.23_b,1,904
207,166,131,218,684,348,336,0,1,1,ABMrun_3.1.23_b,1,902
208,168,133,222,683,344,339,0,1,1,ABMrun_3.1.23_b,1,905
209,172,133,222,673,344,329,0,1,1,ABMrun_3.1.23_b,1,895
210,175,134,225,669,349,320,0,1,1,ABMrun_3.1.23_b,1,894
211,184,136,234,639,332,307,0,1,1,ABMrun_3.1.23_b,1,873
212,171,133,221,688,362,326,0,1,1,ABMrun_3.1.23_b,1,909
213,175,138,224,669,367,302,0,1,1,ABMrun_3.1.23_b,1,893
214,174,139,234,637,332,305,0,1,1,ABMrun_3.1.23_b,1,871
215,179,135,224,665,337,328,0,1,1,ABMrun_3.1.23_b,1,889
216,170,130,225,663,352,311,0,1,1,ABMrun_3.1.23_b,1,888
217,172,136,227,650,329,321,0,1,1,ABMrun_3.1.23_b,1,877
218,174,135,218,681,337,344,0,1,1,ABMrun_3.1.23_b,1,899
219,180,146,228,655,312,343,0,1,1,ABMrun_3.1.23_b,1,883
220,176,141,224,670,333,337,0,1,1,ABMrun_3.1.23_b,1,894
221,176,136,220,675,348,327,0,1,1,ABMrun_3.1.23_b,1,895
222,178,135,232,642,335,307,0,1,1,ABMrun_3.1.23_b,1,874
223,177,139,226,672,358,314,0,1,1,ABMrun_3.1.23_b,1,898
224,163,129,213,696,361,335,0,1,1,ABMrun_3.1.23_b,1,909
225,171,135,221,675,347,328,0,1,1,ABMrun_3.1.23_b,1,896
226,171,133,220,682,343,339,0,1,1,ABMrun_3.1.23_b,1,902
227,181,136,229,647,331,316,0,1,1,ABMrun_3.1.23_b,1,876
228,178,132,225,672,339,333,0,1,1,ABMrun_3.1.23_b,1,897
229,157,127,212,704,344,360,0,1,1,ABMrun_3.1.23_b,1,916
230,183,141,231,648,312,336,0,1,1,ABMrun_3.1.23_b,1,879
231,179,134,233,643,324,319,0,1,1,ABMrun_3.1.23_b,1,876
232,168,134,222,675,331,344,0,1,1,ABMrun_3.1.23_b,1,897
233,172,127,226,668,335,333,0,1,1,ABMrun_3.1.23_b,1,894
234,181,138,226,664,337,327,0,1,1,ABMrun_3.1.23_b,1,890
235,167,130,224,667,341,326,0,1,1,ABMrun_3.1.23_b,1,891
236,177,135,230,660,339,321,0,1,1,ABMrun_3.1.23_b,1,890
237,179,142,230,647,332,315,0,1,1,ABMrun_3.1.23_b,1,877
238,179,140,229,650,327,323,0,1,1,ABMrun_3.1.23_b,1,879
239,178,130,226,668,324,344,0,1,1,ABMrun_3.1.23_b,1,894
240,178,134,230,647,315,332,0,1,1,ABMrun_3.1.23_b,1,877
241,169,130,220,685,341,344,0,1,1,ABMrun_3.1.23_b,1,905
242,163,131,213,699,355,344,0,1,1,ABMrun_3.1.23_b,1,912
243,170,135,225,661,338,323,0,1,1,ABMrun_3.1.23_b,1,886
244,178,143,235,633,310,323,0,1,1,ABMrun_3.1.23_b,1,868
245,175,134,226,667,322,345,0,1,1,ABMrun_3.1.23_b,1,893
246,178,138,223,672,326,346,0,1,1,ABMrun_3.1.23_b,1,895
247,183,139,232,654,314,340,0,1,1,ABMrun_3.1.23_b,1,886
248,185,142,238,620,300,320,0,1,1,ABMrun_3.1.23_b,1,858
249,175,132,227,668,323,345,0,1,1,ABMrun_3.1.23_b,1,895
250,174,133,221,685,340,345,0,1,1,ABMrun_3.1.23_b,1,906
251,152,126,208,719,350,369,0,1,1,ABMrun_3.1.23_b,1,927
252,180,139,232,649,318,331,0,1,1,ABMrun_3.1.23_b,1,881
253,165,137,222,668,343,325,0,1,1,ABMrun_3.1.23_b,1,890
254,172,136,227,660,338,322,0,1,1,ABMrun_3.1.23_b,1,887
255,180,136,227,663,342,321,0,1,1,ABMrun_3.1.23_b,1,890
256,182,138,230,650,325,325,0,1,1,ABMrun_3.1.23_b,1,880
257,175,135,226,656,324,332,0,1,1,ABMrun_3.1.23_b,1,882
258,174,141,228,659,320,339,0,1,1,ABMrun_3.1.23_b,1,887
259,185,145,236,638,324,314,0,1,1,ABMrun_3.1.23_b,1,874
260,177,137,230,650,335,315,0,1,1,ABMrun_3.1.23_b,1,880
261,182,142,228,662,344,318,0,1,1,ABMrun_3.1.23_b,1,890
262,172,134,226,662,340,322,0,1,1,ABMrun_3.1.23_b,1,888
263,173,125,222,662,345,317,0,1,1,ABMrun_3.1.23_b,1,884
264,174,131,224,668,335,333,0,1,1,ABMrun_3.1.23_b,1,892
265,179,138,228,663,337,326,0,1,1,ABMrun_3.1.23_b,1,891
266,175,139,227,659,331,328,0,1,1,ABMrun_3.1.23_b,1,886
267,177,138,227,654,317,337,0,1,1,ABMrun_3.1.23_b,1,881
268,181,147,227,668,337,331,0,1,1,ABMrun_3.1.23_b,1,895
269,170,139,224,667,330,337,0,1,1,ABMrun_3.1.23_b,1,891
270,177,135,229,654,321,333,0,1,1,ABMrun_3.1.23_b,1,883
271,176,132,227,658,329,329,0,1,1,ABMrun_3.1.23_b,1,885
272,168,140,224,675,329,346,0,1,1,ABMrun_3.1.23_b,1,899
273,168,123,213,696,331,365,0,1,1,ABMrun_3.1.23_b,1,909
274,165,137,220,682,326,356,0,1,1,ABMrun_3.1.23_b,1,902
275,169,139,221,674,338,336,0,1,1,ABMrun_3.1.23_b,1,895
276,159,126,214,702,354,348,0,1,1,ABMrun_3.1.23_b,1,916
277,187,137,233,636,339,297,0,1,1,ABMrun_3.1.23_b,1,869
278,173,133,222,686,356,330,0,1,1,ABMrun_3.1.23_b,1,908
279,176,138,224,671,342,329,0,1,1,ABMrun_3.1.23_b,1,895
280,174,128,224,667,334,333,0,1,1,ABMrun_3.1.23_b,1,891
281,178,145,236,635,302,333,0,1,1,ABMrun_3.1.23_b,1,871
282,177,140,228,649,320,329,0,1,1,ABMrun_3.1.23_b,1,877
283,180,125,228,660,342,318,0,1,1,ABMrun_3.1.23_b,1,888
284,184,143,233,649,318,331,0,1,1,ABMrun_3.1.23_b,1,882
285,173,133,225,669,309,360,0,1,1,ABMrun_3.1.23_b,1,894
286,172,130,226,655,311,344,0,1,1,ABMrun_3.1.23_b,1,881
287,178,133,229,646,298,348,0,1,1,ABMrun_3.1.23_b,1,875
288,169,134,228,661,331,330,0,1,1,ABMrun_3.1.23_b,1,889
289,177,137,228,659,334,325,0,1,1,ABMrun_3.1.23_b,1,887
290,172,133,222,681,333,348,0,1,1,ABMrun_3.1.23_b,1,903
291,177,137,222,674,344,330,0,1,1,ABMrun_3.1.23_b,1,896
292,163,129,207,712,359,353,0,1,1,ABMrun_3.1.23_b,1,919
293,170,141,220,682,341,341,0,1,1,ABMrun_3.1.23_b,1,902
294,179,138,223,668,337,331,0,1,1,ABMrun_3.1.23_b,1,891
295,169,139,223,681,334,347,0,1,1,ABMrun_3.1.23_b,1,904
296,173,129,227,665,341,324,0,1,1,ABMrun_3.1.23_b,1,892
297,178,142,224,670,329,341,0,1,1,ABMrun_3.1.23_b,1,894
298,174,135,224,665,312,353,0,1,1,ABMrun_3.1.23_b,1,889
299,169,138,217,682,316,366,0,1,1,ABMrun_3.1.23_b,1,899
300,172,133,222,672,328,344,0,1,1,ABMrun_3.1.23_b,1,894
301,166,132,210,712,351,361,0,1,1,ABMrun_3.1.23_b,1,922
302,175,132,223,672,343,329,0,1,1,ABMrun_3.1.23_b,1,895
303,170,133,230,647,330,317,0,1,1,ABMrun_3.1.23_b,1,877
304,181,146,231,651,307,344,0,1,1,ABMrun_3.1.23_b,1,882
305,185,139,227,659,311,348,0,1,1,ABMrun_3.1.23_b,1,886
306,179,131,228,662,318,344,0,1,1,ABMrun_3.1.23_b,1,890
307,177,131,225,671,321,350,0,1,1,ABMrun_3.1.23_b,1,896
308,171,133,221,683,348,335,0,1,1,ABMrun_3.1.23_b,1,904
309,183,135,228,658,341,317,0,1,1,ABMrun_3.1.23_b,1,886
310,182,133,229,657,323,334,0,1,1,ABMrun_3.1.23_b,1,886
311,170,141,216,693,336,357,0,1,1,ABMrun_3.1.23_b,1,909
312,169,142,218,684,340,344,0,1,1,ABMrun_3.1.23_b,1,902
313,174,134,221,679,340,339,0,1,1,ABMrun_3.1.23_b,1,900
314,170,138,223,680,347,333,0,1,1,ABMrun_3.1.23_b,1,903
315,181,133,232,647,336,311,0,1,1,ABMrun_3.1.23_b,1,879
316,180,133,223,675,330,345,0,1,1,ABMrun_3.1.23_b,1,898
317,176,129,224,677,342,335,0,1,1,ABMrun_3.1.23_b,1,901
318,169,130,227,655,329,326,0,1,1,ABMrun_3.1.23_b,1,882
319,165,139,215,687,339,348,0,1,1,ABMrun_3.1.23_b,1,902
320,177,145,228,661,305,356,0,1,1,ABMrun_3.1.23_b,1,889
321,178,135,230,650,294,356,0,1,1,ABMrun_3.1.23_b,1,880
322,168,139,219,680,322,358,0,1,1,ABMrun_3.1.23_b,1,899
323,182,141,229,654,303,351,0,1,1,ABMrun_3.1.23_b,1,883
324,173,135,226,662,289,373,0,1,1,ABMrun_3.1.23_b,1,888
325,180,139,230,651,299,352,0,1,1,ABMrun_3.1.23_b,1,881
326,158,127,202,723,345,378,0,1,1,ABMrun_3.1.23_b,1,925
327,171,135,226,653,313,340,0,1,1,ABMrun_3.1.23_b,1,879
328,171,128,226,663,333,330,0,1,1,ABMrun_3.1.23_b,1,889
329,176,132,227,656,332,324,0,1,1,ABMrun_3.1.23_b,1,883
330,174,133,224,671,335,336,0,1,1,ABMrun_3.1.23_b,1,895
331,179,134,229,652,343,309,0,1,1,ABMrun_3.1.23_b,1,881
332,177,136,233,646,335,311,0,1,1,ABMrun_3.1.23_b,1,879
333,174,127,226,677,352,325,0,1,1,ABMrun_3.1.23_b,1,903
334,180,136,228,665,343,322,0,1,1,ABMrun_3.1.23_b,1,893
335,170,134,227,662,316,346,0,1,1,ABMrun_3.1.23_b,1,889
336,163,127,217,688,310,378,0,1,1,ABMrun_3.1.23_b,1,905
337,174,139,225,664,281,383,0,1,1,ABMrun_3.1.23_b,1,889
338,171,142,225,671,299,372,0,1,1,ABMrun_3.1.23_b,1,896
339,175,145,224,670,282,388,0,1,1,ABMrun_3.1.23_b,1,894
340,178,151,224,672,301,371,0,1,1,ABMrun_3.1.23_b,1,896
341,181,129,230,655,314,341,0,1,1,ABMrun_3.1.23_b,1,885
342,173,137,222,679,328,351,0,1,1,ABMrun_3.1.23_b,1,901
343,174,135,232,655,329,326,0,1,1,ABMrun_3.1.23_b,1,887
344,172,133,226,659,333,326,0,1,1,ABMrun_3.1.23_b,1,885
345,179,142,224,664,321,343,0,1,1,ABMrun_3.1.23_b,1,888
346,171,133,218,680,319,361,0,1,1,ABMrun_3.1.23_b,1,898
347,166,133,218,686,313,373,0,1,1,ABMrun_3.1.23_b,1,904
348,167,137,216,686,328,358,0,1,1,ABMrun_3.1.23_b,1,902
349,169,133,215,695,330,365,0,1,1,ABMrun_3.1.23_b,1,910
350,175,137,226,656,318,338,0,1,1,ABMrun_3.1.23_b,1,882
1,12,11,16,629,309,320,0,2,1,ABMrun_3.1.23_b,1,645
2,88,82,110,874,443,431,0,2,1,ABMrun_3.1.23_b,1,984
3,141,113,175,788,397,391,0,2,1,ABMrun_3.1.23_b,1,963
4,151,129,201,728,350,378,0,2,1,ABMrun_3.1.23_b,1,929
5,182,150,236,628,291,337,0,2,1,ABMrun_3.1.23_b,1,864
6,186,140,240,616,291,325,0,2,1,ABMrun_3.1.23_b,1,856
7,186,144,231,643,313,330,0,2,1,ABMrun_3.1.23_b,1,874
8,182,129,236,641,327,314,0,2,1,ABMrun_3.1.23_b,1,877
9,180,138,230,667,330,337,0,2,1,ABMrun_3.1.23_b,1,897
10,182,137,233,644,315,329,0,2,1,ABMrun_3.1.23_b,1,877
11,182,139,230,659,331,328,0,2,1,ABMrun_3.1.23_b,1,889
12,181,147,231,652,329,323,0,2,1,ABMrun_3.1.23_b,1,883
13,188,140,232,661,326,335,0,2,1,ABMrun_3.1.23_b,1,893
14,195,147,241,627,315,312,0,2,1,ABMrun_3.1.23_b,1,868
15,176,128,230,665,351,314,0,2,1,ABMrun_3.1.23_b,1,895
16,174,141,226,672,342,330,0,2,1,ABMrun_3.1.23_b,1,898
17,183,144,233,658,342,316,0,2,1,ABMrun_3.1.23_b,1,891
18,168,130,223,675,355,320,0,2,1,ABMrun_3.1.23_b,1,898
19,183,141,230,658,344,314,0,2,1,ABMrun_3.1.23_b,1,888
20,178,132,228,664,355,309,0,2,1,ABMrun_3.1.23_b,1,892
21,173,127,222,681,351,330,0,2,1,ABMrun_3.1.23_b,1,903
22,176,141,227,654,336,318,0,2,1,ABMrun_3.1.23_b,1,881
23,178,136,230,662,340,322,0,2,1,ABMrun_3.1.23_b,1,892
24,179,140,232,647,322,325,0,2,1,ABMrun_3.1.23_b,1,879
25,176,132,227,660,324,336,0,2,1,ABMrun_3.1.23_b,1,887
26,163,133,210,706,349,357,0,2,1,ABMrun_3.1.23_b,1,916
27,180,138,226,678,323,355,0,2,1,ABMrun_3.1.23_b,1,904
28,175,136,223,666,312,354,0,2,1,ABMrun_3.1.23_b,1,889
29,178,127,233,645,303,342,0,2,1,ABMrun_3.1.23_b,1,878
30,178,137,234,651,315,336,0,2,1,ABMrun_3.1.23_b,1,885
31,180,134,230,652,329,323,0,2,1,ABMrun_3.1.23_b,1,882
32,178,139,229,663,351,312,0,2,1,ABMrun_3.1.23_b,1,892
33,183,139,229,668,355,313,0,2,1,ABMrun_3.1.23_b,1,897
34,176,131,231,644,339,305,0,2,1,ABMrun_3.1.23_b,1,875
35,178,131,231,648,329,319,0,2,1,ABMrun_3.1.23_b,1,879
36,191,143,236,643,325,318,0,2,1,ABMrun_3.1.23_b,1,879
37,165,134,212,697,343,354,0,2,1,ABMrun_3.1.23_b,1,909
38,172,135,223,676,325,351,0,2,1,ABMrun_3.1.23_b,1,899
39,179,137,231,651,328,323,0,2,1,ABMrun_3.1.23_b,1,882
40,170,137,227,655,344,311,0,2,1,ABMrun_3.1.23_b,1,882
41,183,144,229,664,335,329,0,2,1,ABMrun_3.1.23_b,1,893
42,179,138,227,660,343,317,0,2,1,ABMrun_3.1.23_b,1,887
43,173,135,224,672,361,311,0,2,1,ABMrun_3.1.23_b,1,896
44,176,139,227,661,331,330,0,2,1,ABMrun_3.1.23_b,1,888
45,178,136,228,665,333,332,0,2,1,ABMrun_3.1.23_b,1,893
46,176,137,225,670,328,342,0,2,1,ABMrun_3.1.23_b,1,895
47,183,141,234,644,315,329,0,2,1,ABMrun_3.1.23_b,1,878
48,174,141,226,669,324,345,0,2,1,ABMrun_3.1.23_b,1,895
49,177,133,224,669,319,350,0,2,1,ABMrun_3.1.23_b,1,893
50,180,143,236,635,302,333,0,2,1,ABMrun_3.1.23_b,1,871
51,160,126,214,710,342,368,0,2,1,ABMrun_3.1.23_b,1,924
52,172,140,222,674,337,337,0,2,1,ABMrun_3.1.23_b,1,896
53,178,141,223,677,337,340,0,2,1,ABMrun_3.1.23_b,1,900
54,179,145,234,643,312,331,0,2,1,ABMrun_3.1.23_b,1,877
55,177,138,230,661,325,336,0,2,1,ABMrun_3.1.23_b,1,891
56,173,129,227,671,337,334,0,2,1,ABMrun_3.1.23_b,1,898
57,183,139,231,655,354,301,0,2,1,ABMrun_3.1.23_b,1,886
58,180,134,232,659,353,306,0,2,1,ABMrun_3.1.23_b,1,891
59,174,136,230,659,336,323,0,2,1,ABMrun_3.1.23_b,1,889
60,174,133,229,654,336,318,0,2,1,ABMrun_3.1.23_b,1,883
61,181,137,224,681,342,339,0,2,1,ABMrun_3.1.23_b,1,905
62,195,143,237,636,307,329,0,2,1,ABMrun_3.1.23_b,1,873
63,176,137,229,657,312,345,0,2,1,ABMrun_3.1.23_b,1,886
64,180,133,231,654,313,341,0,2,1,ABMrun_3.1.23_b,1,885
65,185,139,228,666,338,328,0,2,1,ABMrun_3.1.23_b,1,894
66,181,140,228,665,360,305,0,2,1,ABMrun_3.1.23_b,1,893
67,181,132,232,651,361,290,0,2,1,ABMrun_3.1.23_b,1,883
68,187,134,237,627,352,275,0,2,1,ABMrun_3.1.23_b,1,864
69,179,139,235,638,348,290,0,2,1,ABMrun_3.1.23_b,1,873
70,181,135,239,625,322,303,0,2,1,ABMrun_3.1.23_b,1,864
71,173,125,225,665,362,303,0,2,1,ABMrun_3.1.23_b,1,890
72,180,133,228,662,336,326,0,2,1,ABMrun_3.1.23_b,1,890
73,178,128,228,659,337,322,0,2,1,ABMrun_3.1.23_b,1,887
74,176,135,225,669,327,342,0,2,1,ABMrun_3.1.23_b,1,894
75,175,141,219,682,336,346,0,2,1,ABMrun_3.1.23_b,1,901
76,154,121,204,729,364,365,0,2,1,ABMrun_3.1.23_b,1,933
77,175,133,223,677,322,355,0,2,1,ABMrun_3.1.23_b,1,900
78,179,141,227,662,322,340,0,2,1,ABMrun_3.1.23_b,1,889
79,184,142,233,653,320,333,0,2,1,ABMrun_3.1.23_b,1,886
80,177,141,229,662,326,336,0,2,1,ABMrun_3.1.23_b,1,891
81,176,146,225,667,323,344,0,2,1,ABMrun_3.1.23_b,1,892
82,173,137,228,666,322,344,0,2,1,ABMrun_3.1.23_b,1,894
83,175,130,233,641,325,316,0,2,1,ABMrun_3.1.23_b,1,874
84,179,141,232,653,334,319,0,2,1,ABMrun_3.1.23_b,1,885
85,175,130,229,653,343,310,0,2,1,ABMrun_3.1.23_b,1,882
86,181,134,228,659,341,318,0,2,1,ABMrun_3.1.23_b,1,887
87,193,142,237,625,318,307,0,2,1,ABMrun_3.1.23_b,1,862
88,166,133,225,671,342,329,0,2,1,ABMrun_3.1.23_b,1,896
89,186,144,237,629,323,306,0,2,1,ABMrun_3.1.23_b,1,866
90,176,133,232,649,335,314,0,2,1,ABMrun_3.1.23_b,1,881
91,175,131,225,670,335,335,0,2,1,ABMrun_3.1.23_b,1,895
92,175,139,222,690,330,360,0,2,1,ABMrun_3.1.23_b,1,912
93,185,144,232,642,292,350,0,2,1,ABMrun_3.1.23_b,1,874
94,180,139,227,668,323,345,0,2,1,ABMrun_3.1.23_b,1,895
95,177,135,225,667,345,322,0,2,1,ABMrun_3.1.23_b,1,892
96,176,132,230,649,333,316,0,2,1,ABMrun_3.1.23_b,1,879
97,183,135,237,631,312,319,0,2,1,ABMrun_3.1.23_b,1,868
98,184,135,231,655,320,335,0,2,1,ABMrun_3.1.23_b,1,886
99,184,136,229,657,323,334,0,2,1,ABMrun_3.1.23_b,1,886
100,173,135,218,650,323,327,0,2,1,ABMrun_3.1.23_b,1,868
101,151,124,195,686,364,322,0,2,1,ABMrun_3.1.23_b,1,881
102,152,122,195,635,332,303,0,2,1,ABMrun_3.1.23_b,1,830
103,154,115,201,584,313,271,0,2,1,ABMrun_3.1.23_b,1,785
104,142,114,188,582,306,276,0,2,1,ABMrun_3.1.23_b,1,770
105,136,108,180,557,285,272,0,2,1,ABMrun_3.1.23_b,1,737
106,128,109,167,557,279,278,0,2,1,ABMrun_3.1.23_b,1,724
107,138,107,170,524,275,249,0,2,1,ABMrun_3.1.23_b,1,694
108,125,97,164,495,241,254,0,2,1,ABMrun_3.1.23_b,1,659
109,104,84,143,515,251,264,0,2,1,ABMrun_3.1.23_b,1,658
110,64,56,80,462,220,242,0,2,1,ABMrun_3.1.23_b,1,542
111,71,59,87,371,173,198,0,2,1,ABMrun_3.1.23_b,1,458
112,69,57,88,334,150,184,0,2,1,ABMrun_3.1.23_b,1,422
113,63,52,83,296,141,155,0,2,1,ABMrun_3.1.23_b,1,379
114,62,49,79,247,128,119,0,2,1,ABMrun_3.1.23_b,1,326
115,59,44,76,228,119,109,0,2,1,ABMrun_3.1.23_b,1,304
116,58,42,75,233,116,117,0,2,1,ABMrun_3.1.23_b,1,308
117,62,50,76,229,114,115,0,2,1,ABMrun_3.1.23_b,1,305
118,58,41,75,226,109,117,0,2,1,ABMrun_3.1.23_b,1,301
119,62,44,75,221,104,117,0,2,1,ABMrun_3.1.23_b,1,296
120,60,44,75,230,111,119,0,2,1,ABMrun_3.1.23_b,1,305
121,54,43,73,204,99,105,0,2,1,ABMrun_3.1.23_b,1,277
122,56,44,75,219,105,114,0,2,1,ABMrun_3.1.23_b,1,294
123,61,50,75,231,112,119,0,2,1,ABMrun_3.1.23_b,1,306
124,58,46,74,220,106,114,0,2,1,ABMrun_3.1.23_b,1,294
125,58,47,75,227,110,117,0,2,1,ABMrun_3.1.23_b,1,302
126,63,48,80,250,125,125,0,2,1,ABMrun_3.1.23_b,1,330
127,61,46,79,244,116,128,0,2,1,ABMrun_3.1.23_b,1,323
128,62,45,78,245,122,123,0,2,1,ABMrun_3.1.23_b,1,323
129,62,46,75,220,114,106,0,2,1,ABMrun_3.1.23_b,1,295
130,57,43,74,218,107,111,0,2,1,ABMrun_3.1.23_b,1,292
131,56,39,72,212,103,109,0,2,1,ABMrun_3.1.23_b,1,284
132,57,47,70,210,98,112,0,2,1,ABMrun_3.1.23_b,1,280
133,56,44,73,204,105,99,0,2,1,ABMrun_3.1.23_b,1,277
134,59,41,69,199,104,95,0,2,1,ABMrun_3.1.23_b,1,268
135,55,42,69,188,106,82,0,2,1,ABMrun_3.1.23_b,1,257
136,54,39,69,190,107,83,0,2,1,ABMrun_3.1.23_b,1,259
137,56,42,71,198,115,83,0,2,1,ABMrun_3.1.23_b,1,269
138,57,42,73,210,118,92,0,2,1,ABMrun_3.1.23_b,1,283
139,57,46,74,212,114,98,0,2,1,ABMrun_3.1.23_b,1,286
140,58,44,73,211,113,98,0,2,1,ABMrun_3.1.23_b,1,284
141,66,45,75,213,114,99,0,2,1,ABMrun_3.1.23_b,1,288
142,54,40,72,215,109,106,0,2,1,ABMrun_3.1.23_b,1,287
143,56,39,72,210,111,99,0,2,1,ABMrun_3.1.23_b,1,282
144,61,48,73,212,108,104,0,2,1,ABMrun_3.1.23_b,1,285
145,56,43,73,210,99,111,0,2,1,ABMrun_3.1.23_b,1,283
146,55,47,73,206,94,112,0,2,1,ABMrun_3.1.23_b,1,279
147,58,45,75,212,101,111,0,2,1,ABMrun_3.1.23_b,1,287
148,57,43,75,217,110,107,0,2,1,ABMrun_3.1.23_b,1,292
149,57,42,76,220,116,104,0,2,1,ABMrun_3.1.23_b,1,296
150,58,46,76,230,121,109,0,2,1,ABMrun_3.1.23_b,1,306
151,123,69,166,262,140,122,18,2,1,ABMrun_3.1.23_b,1,428
152,137,84,186,328,176,152,7,2,1,ABMrun_3.1.23_b,1,514
153,153,98,197,419,234,185,2,2,1,ABMrun_3.1.23_b,1,616
154,154,111,203,462,243,219,1,2,1,ABMrun_3.1.23_b,1,665
155,161,120,207,500,251,249,0,2,1,ABMrun_3.1.23_b,1,707
156,165,117,213,537,264,273,1,2,1,ABMrun_3.1.23_b,1,750
157,168,124,210,589,285,304,1,2,1,ABMrun_3.1.23_b,1,799
158,169,133,217,605,297,308,0,2,1,ABMrun_3.1.23_b,1,822
159,178,127,235,593,302,291,0,2,1,ABMrun_3.1.23_b,1,828
160,190,135,242,622,313,309,0,2,1,ABMrun_3.1.23_b,1,864
161,184,136,230,649,319,330,0,2,1,ABMrun_3.1.23_b,1,879
162,180,140,234,647,305,342,0,2,1,ABMrun_3.1.23_b,1,881
163,172,135,224,672,328,344,0,2,1,ABMrun_3.1.23_b,1,896
164,177,133,230,650,300,350,0,2,1,ABMrun_3.1.23_b,1,880
165,166,139,212,696,322,374,13,2,1,ABMrun_3.1.23_b,1,908
166,183,150,229,661,324,337,9,2,1,ABMrun_3.1.23_b,1,890
167,187,139,233,653,320,333,3,2,1,ABMrun_3.1.23_b,1,886
168,180,142,230,649,297,352,2,2,1,ABMrun_3.1.23_b,1,879
169,181,144,230,646,299,347,0,2,1,ABMrun_3.1.23_b,1,876
170,175,135,226,658,301,357,0,2,1,ABMrun_3.1.23_b,1,884
171,183,143,227,665,303,362,0,2,1,ABMrun_3.1.23_b,1,892
172,170,125,221,678,312,366,0,2,1,ABMrun_3.1.23_b,1,899
173,180,141,226,659,317,342,0,2,1,ABMrun_3.1.23_b,1,885
174,176,139,228,670,336,334,0,2,1,ABMrun_3.1.23_b,1,898
175,178,141,230,651,337,314,0,2,1,ABMrun_3.1.23_b,1,881
176,158,127,199,731,375,356,0,2,1,ABMrun_3.1.23_b,1,930
177,175,139,223,669,335,334,0,2,1,ABMrun_3.1.23_b,1,892
178,172,136,223,672,330,342,0,2,1,ABMrun_3.1.23_b,1,895
179,174,139,224,670,326,344,0,2,1,ABMrun_3.1.23_b,1,894
180,174,128,228,652,328,324,0,2,1,ABMrun_3.1.23_b,1,880
181,174,131,222,662,331,331,10,2,1,ABMrun_3.1.23_b,1,884
182,175,136,226,669,336,333,2,2,1,ABMrun_3.1.23_b,1,895
183,177,145,233,647,323,324,4,2,1,ABMrun_3.1.23_b,1,880
184,170,126,223,663,335,328,2,2,1,ABMrun_3.1.23_b,1,886
185,176,135,228,661,339,322,1,2,1,ABMrun_3.1.23_b,1,889
186,175,134,223,666,336,330,1,2,1,ABMrun_3.1.23_b,1,889
187,172,123,229,659,338,321,0,2,1,ABMrun_3.1.23_b,1,888
188,179,134,230,653,322,331,0,2,1,ABMrun_3.1.23_b,1,883
189,171,127,221,674,346,328,0,2,1,ABMrun_3.1.23_b,1,895
190,173,139,223,676,324,352,0,2,1,ABMrun_3.1.23_b,1,899
191,175,142,230,659,304,355,0,2,1,ABMrun_3.1.23_b,1,889
192,180,135,226,670,317,353,0,2,1,ABMrun_3.1.23_b,1,896
193,178,144,222,678,320,358,0,2,1,ABMrun_3.1.23_b,1,900
194,175,140,229,656,311,345,0,2,1,ABMrun_3.1.23_b,1,885
195,175,135,229,669,320,349,10,2,1,ABMrun_3.1.23_b,1,898
196,179,145,228,654,314,340,5,2,1,ABMrun_3.1.23_b,1,882
197,173,127,227,665,338,327,5,2,1,ABMrun_3.1.23_b,1,892
198,181,139,228,660,340,320,1,2,1,ABMrun_3.1.23_b,1,888
199,177,128,230,651,329,322,1,2,1,ABMrun_3.1.23_b,1,881
200,182,139,230,649,331,318,1,2,1,ABMrun_3.1.23_b,1,879
201,164,139,207,722,360,362,0,2,1,ABMrun_3.1.23_b,1,929
202,173,139,223,679,340,339,0,2,1,ABMrun_3.1.23_b,1,902
203,178,130,230,658,333,325,0,2,1,ABMrun_3.1.23_b,1,888
204,175,130,229,650,330,320,0,2,1,ABMrun_3.1.23_b,1,879
205,167,132,221,680,355,325,0,2,1,ABMrun_3.1.23_b,1,901
206,177,138,226,666,352,314,0,2,1,ABMrun_3.1.23_b,1,892
207,179,141,229,651,328,323,0,2,1,ABMrun_3.1.23_b,1,880
208,177,131,232,653,333,320,0,2,1,ABMrun_3.1.23_b,1,885
209,180,136,226,660,337,323,0,2,1,ABMrun_3.1.23_b,1,886
210,178,135,232,648,337,311,0,2,1,ABMrun_3.1.23_b,1,880
211,171,129,231,645,326,319,0,2,1,ABMrun_3.1.23_b,1,876
212,173,134,226,657,336,321,0,2,1,ABMrun_3.1.23_b,1,883
213,176,134,228,664,332,332,0,2,1,ABMrun_3.1.23_b,1,892
214,174,138,232,646,322,324,0,2,1,ABMrun_3.1.23_b,1,878
215,171,129,221,673,337,336,0,2,1,ABMrun_3.1.23_b,1,894
216,169,125,221,678,314,364,0,2,1,ABMrun_3.1.23_b,1,899
217,167,131,216,691,328,363,0,2,1,ABMrun_3.1.23_b,1,907
218,166,135,224,663,297,366,0,2,1,ABMrun_3.1.23_b,1,887
219,176,147,223,673,304,369,0,2,1,ABMrun_3.1.23_b,1,896
220,177,138,220,675,307,368,0,2,1,ABMrun_3.1.23_b,1,895
221,180,138,228,653,311,342,0,2,1,ABMrun_3.1.23_b,1,881
222,176,139,226,661,322,339,0,2,1,ABMrun_3.1.23_b,1,887
223,174,137,227,669,342,327,0,2,1,ABMrun_3.1.23_b,1,896
224,182,142,226,666,313,353,0,2,1,ABMrun_3.1.23_b,1,892
225,178,143,231,648,296,352,0,2,1,ABMrun_3.1.23_b,1,879
226,157,135,206,714,347,367,0,2,1,ABMrun_3.1.23_b,1,920
227,168,132,218,683,349,334,0,2,1,ABMrun_3.1.23_b,1,901
228,173,137,225,677,342,335,0,2,1,ABMrun_3.1.23_b,1,902
229,175,138,231,655,326,329,0,2,1,ABMrun_3.1.23_b,1,886
230,177,131,226,660,321,339,0,2,1,ABMrun_3.1.23_b,1,886
231,182,138,223,668,316,352,0,2,1,ABMrun_3.1.23_b,1,891
232,182,146,228,660,313,347,0,2,1,ABMrun_3.1.23_b,1,888
233,174,123,228,655,325,330,0,2,1,ABMrun_3.1.23_b,1,883
234,171,130,218,682,348,334,0,2,1,ABMrun_3.1.23_b,1,900
235,178,140,227,659,345,314,0,2,1,ABMrun_3.1.23_b,1,886
236,173,125,225,669,356,313,0,2,1,ABMrun_3.1.23_b,1,894
237,185,139,232,652,339,313,0,2,1,ABMrun_3.1.23_b,1,884
238,179,146,232,645,332,313,0,2,1,ABMrun_3.1.23_b,1,877
239,180,136,228,648,342,306,0,2,1,ABMrun_3.1.23_b,1,876
240,181,132,234,646,354,292,0,2,1,ABMrun_3.1.23_b,1,880
241,181,134,229,659,345,314,0,2,1,ABMrun_3.1.23_b,1,888
242,182,147,224,663,321,342,0,2,1,ABMrun_3.1.23_b,1,887
243,176,143,222,678,318,360,0,2,1,ABMrun_3.1.23_b,1,900
244,178,135,224,662,311,351,0,2,1,ABMrun_3.1.23_b,1,886
245,188,141,237,630,306,324,0,2,1,ABMrun_3.1.23_b,1,867
246,176,140,228,655,326,329,0,2,1,ABMrun_3.1.23_b,1,883
247,171,135,217,692,343,349,0,2,1,ABMrun_3.1.23_b,1,909
248,165,126,218,686,342,344,0,2,1,ABMrun_3.1.23_b,1,904
249,182,138,230,649,325,324,0,2,1,ABMrun_3.1.23_b,1,879
250,184,138,239,632,322,310,0,2,1,ABMrun_3.1.23_b,1,871
251,162,134,204,724,371,353,0,2,1,ABMrun_3.1.23_b,1,928
252,173,140,224,668,329,339,0,2,1,ABMrun_3.1.23_b,1,892
253,170,132,226,665,333,332,0,2,1,ABMrun_3.1.23_b,1,891
254,172,127,227,660,321,339,0,2,1,ABMrun_3.1.23_b,1,887
255,177,132,228,649,315,334,0,2,1,ABMrun_3.1.23_b,1,877
256,168,139,223,680,323,357,0,2,1,ABMrun_3.1.23_b,1,903
257,168,135,219,686,310,376,0,2,1,ABMrun_3.1.23_b,1,905
258,178,137,230,664,306,358,0,2,1,ABMrun_3.1.23_b,1,894
259,172,137,223,672,328,344,0,2,1,ABMrun_3.1.23_b,1,895
260,175,131,228,663,329,334,0,2,1,ABMrun_3.1.23_b,1,891
261,178,138,232,645,323,322,0,2,1,ABMrun_3.1.23_b,1,877
262,176,130,225,667,342,325,0,2,1,ABMrun_3.1.23_b,1,892
263,185,144,232,644,318,326,0,2,1,ABMrun_3.1.23_b,1,876
264,165,134,213,694,342,352,0,2,1,ABMrun_3.1.23_b,1,907
265,174,133,225,665,339,326,0,2,1,ABMrun_3.1.23_b,1,890
266,179,136,227,666,334,332,0,2,1,ABMrun_3.1.23_b,1,893
267,175,139,223,669,342,327,0,2,1,ABMrun_3.1.23_b,1,892
268,188,140,238,626,320,306,0,2,1,ABMrun_3.1.23_b,1,864
269,178,140,228,668,335,333,0,2,1,ABMrun_3.1.23_b,1,896
270,174,132,224,663,327,336,0,2,1,ABMrun_3.1.23_b,1,887
271,181,141,227,659,311,348,0,2,1,ABMrun_3.1.23_b,1,886
272,179,140,231,648,329,319,0,2,1,ABMrun_3.1.23_b,1,879
273,172,125,225,664,352,312,0,2,1,ABMrun_3.1.23_b,1,889
274,180,140,233,638,326,312,0,2,1,ABMrun_3.1.23_b,1,871
275,168,131,223,669,331,338,0,2,1,ABMrun_3.1.23_b,1,892
276,159,130,204,723,330,393,0,2,1,ABMrun_3.1.23_b,1,927
277,175,137,221,681,322,359,0,2,1,ABMrun_3.1.23_b,1,902
278,172,141,224,663,328,335,0,2,1,ABMrun_3.1.23_b,1,887
279,176,133,230,650,327,323,0,2,1,ABMrun_3.1.23_b,1,880
280,184,139,230,653,336,317,0,2,1,ABMrun_3.1.23_b,1,883
281,172,127,225,658,336,322,0,2,1,ABMrun_3.1.23_b,1,883
282,180,137,228,656,352,304,0,2,1,ABMrun_3.1.23_b,1,884
283,181,141,229,656,329,327,0,2,1,ABMrun_3.1.23_b,1,885
284,181,144,235,634,328,306,0,2,1,ABMrun_3.1.23_b,1,869
285,178,136,226,659,330,329,0,2,1,ABMrun_3.1.23_b,1,885
286,171,129,222,676,334,342,0,2,1,ABMrun_3.1.23_b,1,898
287,176,130,229,666,329,337,0,2,1,ABMrun_3.1.23_b,1,895
288,184,135,223,669,329,340,0,2,1,ABMrun_3.1.23_b,1,892
289,173,132,222,670,338,332,0,2,1,ABMrun_3.1.23_b,1,892
290,174,138,224,665,342,323,0,2,1,ABMrun_3.1.23_b,1,889
291,173,135,228,660,352,308,0,2,1,ABMrun_3.1.23_b,1,888
292,174,128,227,668,361,307,0,2,1,ABMrun_3.1.23_b,1,895
293,181,142,227,661,349,312,0,2,1,ABMrun_3.1.23_b,1,888
294,180,138,226,661,327,334,0,2,1,ABMrun_3.1.23_b,1,887
295,174,139,227,659,315,344,0,2,1,ABMrun_3.1.23_b,1,886
296,173,139,223,675,330,345,0,2,1,ABMrun_3.1.23_b,1,898
297,165,131,221,668,326,342,0,2,1,ABMrun_3.1.23_b,1,889
298,167,133,227,653,309,344,0,2,1,ABMrun_3.1.23_b,1,880
299,174,139,227,662,313,349,0,2,1,ABMrun_3.1.23_b,1,889
300,175,140,216,694,339,355,0,2,1,ABMrun_3.1.23_b,1,910
301,159,125,205,715,360,355,0,2,1,ABMrun_3.1.23_b,1,920
302,182,131,236,639,348,291,0,2,1,ABMrun_3.1.23_b,1,875
303,173,138,229,653,332,321,0,2,1,ABMrun_3.1.23_b,1,882
304,183,127,239,628,317,311,0,2,1,ABMrun_3.1.23_b,1,867
305,180,141,225,669,346,323,0,2,1,ABMrun_3.1.23_b,1,894
306,175,138,226,659,317,342,0,2,1,ABMrun_3.1.23_b,1,885
307,180,136,226,664,308,356,0,2,1,ABMrun_3.1.23_b,1,890
308,179,131,230,653,327,326,0,2,1,ABMrun_3.1.23_b,1,883
309,176,137,223,676,329,347,0,2,1,ABMrun_3.1.23_b,1,899
310,171,137,221,679,344,335,0,2,1,ABMrun_3.1.23_b,1,900
311,181,143,229,659,322,337,0,2,1,ABMrun_3.1.23_b,1,888
312,179,140,227,656,316,340,0,2,1,ABMrun_3.1.23_b,1,883
313,182,142,227,670,323,347,0,2,1,ABMrun_3.1.23_b,1,897
314,175,137,230,651,315,336,0,2,1,ABMrun_3.1.23_b,1,881
315,170,131,223,671,312,359,0,2,1,ABMrun_3.1.23_b,1,894
316,174,128,225,673,324,349,0,2,1,ABMrun_3.1.23_b,1,898
317,176,131,228,659,334,325,0,2,1,ABMrun_3.1.23_b,1,887
318,175,134,226,664,318,346,0,2,1,ABMrun_3.1.23_b,1,890
319,170,133,220,681,322,359,0,2,1,ABMrun_3.1.23_b,1,901
320,175,129,224,675,316,359,0,2,1,ABMrun_3.1.23_b,1,899
321,180,140,229,648,312,336,0,2,1,ABMrun_3.1.23_b,1,877
322,179,145,227,665,322,343,0,2,1,ABMrun_3.1.23_b,1,892
323,166,125,219,684,322,362,0,2,1,ABMrun_3.1.23_b,1,903
324,178,139,226,663,313,350,0,2,1,ABMrun_3.1.23_b,1,889
325,177,144,228,664,327,337,0,2,1,ABMrun_3.1.23_b,1,892
326,159,133,204,723,349,374,0,2,1,ABMrun_3.1.23_b,1,927
327,181,135,233,646,306,340,0,2,1,ABMrun_3.1.23_b,1,879
328,180,136,230,652,320,332,0,2,1,ABMrun_3.1.23_b,1,882
329,188,146,237,631,318,313,0,2,1,ABMrun_3.1.23_b,1,868
330,173,142,223,672,338,334,0,2,1,ABMrun_3.1.23_b,1,895
331,174,139,224,670,313,357,0,2,1,ABMrun_3.1.23_b,1,894
332,186,144,226,665,323,342,0,2,1,ABMrun_3.1.23_b,1,891
333,172,138,225,664,314,350,0,2,1,ABMrun_3.1.23_b,1,889
334,171,135,220,683,333,350,0,2,1,ABMrun_3.1.23_b,1,903
335,174,137,227,658,310,348,0,2,1,ABMrun_3.1.23_b,1,885
336,177,136,233,650,316,334,0,2,1,ABMrun_3.1.23_b,1,883
337,176,135,223,675,323,352,0,2,1,ABMrun_3.1.23_b,1,898
338,175,138,227,666,306,360,0,2,1,ABMrun_3.1.23_b,1,893
339,170,129,218,688,326,362,0,2,1,ABMrun_3.1.23_b,1,906
340,171,146,220,677,324,353,0,2,1,ABMrun_3.1.23_b,1,897
341,180,147,235,630,304,326,0,2,1,ABMrun_3.1.23_b,1,865
342,181,143,224,669,328,341,0,2,1,ABMrun_3.1.23_b,1,893
343,176,134,225,674,331,343,0,2,1,ABMrun_3.1.23_b,1,899
344,174,138,222,677,347,330,0,2,1,ABMrun_3.1.23_b,1,899
345,176,132,222,677,350,327,0,2,1,ABMrun_3.1.23_b,1,899
346,181,129,230,646,330,316,0,2,1,ABMrun_3.1.23_b,1,876
347,175,139,227,656,315,341,0,2,1,ABMrun_3.1.23_b,1,883
348,177,144,226,659,302,357,0,2,1,ABMrun_3.1.23_b,1,885
349,168,133,225,672,320,352,0,2,1,ABMrun_3.1.23_b,1,897
350,178,139,224,664,321,343,0,2,1,ABMrun_3.1.23_b,1,888
1,18,18,21,623,337,286,0,3,1,ABMrun_3.1.23_b,1,644
2,105,91,132,849,444,405,0,3,1,ABMrun_3.1.23_b,1,981
3,120,104,155,813,412,401,0,3,1,ABMrun_3.1.23_b,1,968
4,164,134,206,730,376,354,0,3,1,ABMrun_3.1.23_b,1,936
5,175,134,226,665,332,333,0,3,1,ABMrun_3.1.23_b,1,891
6,179,133,233,649,324,325,0,3,1,ABMrun_3.1.23_b,1,882
7,187,147,231,653,339,314,0,3,1,ABMrun_3.1.23_b,1,884
8,182,143,232,644,325,319,0,3,1,ABMrun_3.1.23_b,1,876
9,186,137,230,654,344,310,0,3,1,ABMrun_3.1.23_b,1,884
10,172,134,226,672,343,329,0,3,1,ABMrun_3.1.23_b,1,898
11,183,140,229,667,322,345,0,3,1,ABMrun_3.1.23_b,1,896
12,174,137,231,664,322,342,0,3,1,ABMrun_3.1.23_b,1,895
13,185,141,236,627,317,310,0,3,1,ABMrun_3.1.23_b,1,863
14,186,138,240,616,307,309,0,3,1,ABMrun_3.1.23_b,1,856
15,182,139,239,622,294,328,0,3,1,ABMrun_3.1.23_b,1,861
16,179,142,230,653,320,333,0,3,1,ABMrun_3.1.23_b,1,883
17,182,133,230,662,318,344,0,3,1,ABMrun_3.1.23_b,1,892
18,170,138,220,680,335,345,0,3,1,ABMrun_3.1.23_b,1,900
19,168,137,215,698,351,347,0,3,1,ABMrun_3.1.23_b,1,913
20,180,129,226,672,339,333,0,3,1,ABMrun_3.1.23_b,1,898
21,175,135,225,675,345,330,0,3,1,ABMrun_3.1.23_b,1,900
22,177,133,230,654,331,323,0,3,1,ABMrun_3.1.23_b,1,884
23,179,136,229,666,326,340,0,3,1,ABMrun_3.1.23_b,1,895
24,177,136,227,663,325,338,0,3,1,ABMrun_3.1.23_b,1,890
25,179,137,234,646,310,336,0,3,1,ABMrun_3.1.23_b,1,880
26,175,139,222,690,334,356,0,3,1,ABMrun_3.1.23_b,1,912
27,181,139,232,653,313,340,0,3,1,ABMrun_3.1.23_b,1,885
28,186,142,237,625,300,325,0,3,1,ABMrun_3.1.23_b,1,862
29,178,132,231,654,327,327,0,3,1,ABMrun_3.1.23_b,1,885
30,175,134,222,683,339,344,0,3,1,ABMrun_3.1.23_b,1,905
31,172,130,225,678,342,336,0,3,1,ABMrun_3.1.23_b,1,903
32,178,140,232,650,319,331,0,3,1,ABMrun_3.1.23_b,1,882
33,175,134,227,660,328,332,0,3,1,ABMrun_3.1.23_b,1,887
34,182,142,224,670,336,334,0,3,1,ABMrun_3.1.23_b,1,894
35,177,137,227,668,334,334,0,3,1,ABMrun_3.1.23_b,1,895
36,183,147,235,645,321,324,0,3,1,ABMrun_3.1.23_b,1,880
37,174,135,226,666,331,335,0,3,1,ABMrun_3.1.23_b,1,892
38,176,135,228,669,337,332,0,3,1,ABMrun_3.1.23_b,1,897
39,174,133,230,657,321,336,0,3,1,ABMrun_3.1.23_b,1,887
40,175,141,226,673,323,350,0,3,1,ABMrun_3.1.23_b,1,899
41,174,143,229,665,316,349,0,3,1,ABMrun_3.1.23_b,1,894
42,182,142,229,655,326,329,0,3,1,ABMrun_3.1.23_b,1,884
43,182,139,236,648,330,318,0,3,1,ABMrun_3.1.23_b,1,884
44,182,141,233,647,322,325,0,3,1,ABMrun_3.1.23_b,1,880
45,178,140,230,654,330,324,0,3,1,ABMrun_3.1.23_b,1,884
46,174,139,224,673,336,337,0,3,1,ABMrun_3.1.23_b,1,897
47,180,135,230,661,335,326,0,3,1,ABMrun_3.1.23_b,1,891
48,183,138,227,664,340,324,0,3,1,ABMrun_3.1.23_b,1,891
49,170,143,226,668,337,331,0,3,1,ABMrun_3.1.23_b,1,894
50,174,139,228,657,333,324,0,3,1,ABMrun_3.1.23_b,1,885
51,162,127,209,716,379,337,0,3,1,ABMrun_3.1.23_b,1,925
52,175,130,227,663,340,323,0,3,1,ABMrun_3.1.23_b,1,890
53,180,136,230,657,328,329,0,3,1,ABMrun_3.1.23_b,1,887
54,184,136,237,629,309,320,0,3,1,ABMrun_3.1.23_b,1,866
55,178,138,228,670,324,346,0,3,1,ABMrun_3.1.23_b,1,898
56,175,134,225,670,337,333,0,3,1,ABMrun_3.1.23_b,1,895
57,176,134,229,658,318,340,0,3,1,ABMrun_3.1.23_b,1,887
58,176,140,229,663,324,339,0,3,1,ABMrun_3.1.23_b,1,892
59,169,132,228,666,314,352,0,3,1,ABMrun_3.1.23_b,1,894
60,176,138,226,668,331,337,0,3,1,ABMrun_3.1.23_b,1,894
61,184,137,234,646,326,320,0,3,1,ABMrun_3.1.23_b,1,880
62,177,136,230,655,328,327,0,3,1,ABMrun_3.1.23_b,1,885
63,174,135,225,675,327,348,0,3,1,ABMrun_3.1.23_b,1,900
64,182,130,234,642,301,341,0,3,1,ABMrun_3.1.23_b,1,876
65,187,149,234,640,319,321,0,3,1,ABMrun_3.1.23_b,1,874
66,173,137,223,679,337,342,0,3,1,ABMrun_3.1.23_b,1,902
67,183,144,227,655,338,317,0,3,1,ABMrun_3.1.23_b,1,882
68,180,132,236,647,334,313,0,3,1,ABMrun_3.1.23_b,1,883
69,182,138,235,647,328,319,0,3,1,ABMrun_3.1.23_b,1,882
70,176,123,230,649,329,320,0,3,1,ABMrun_3.1.23_b,1,879
71,171,140,220,687,330,357,0,3,1,ABMrun_3.1.23_b,1,907
72,170,135,223,677,313,364,0,3,1,ABMrun_3.1.23_b,1,900
73,175,146,230,661,301,360,0,3,1,ABMrun_3.1.23_b,1,891
74,180,142,233,640,305,335,0,3,1,ABMrun_3.1.23_b,1,873
75,181,151,227,656,332,324,0,3,1,ABMrun_3.1.23_b,1,883
76,154,129,208,714,363,351,0,3,1,ABMrun_3.1.23_b,1,922
77,180,143,229,668,314,354,0,3,1,ABMrun_3.1.23_b,1,897
78,172,134,230,652,317,335,0,3,1,ABMrun_3.1.23_b,1,882
79,177,137,234,652,311,341,0,3,1,ABMrun_3.1.23_b,1,886
80,180,137,232,647,314,333,0,3,1,ABMrun_3.1.23_b,1,879
81,176,133,229,664,316,348,0,3,1,ABMrun_3.1.23_b,1,893
82,173,143,219,687,319,368,0,3,1,ABMrun_3.1.23_b,1,906
83,177,138,224,671,322,349,0,3,1,ABMrun_3.1.23_b,1,895
84,179,142,234,638,310,328,0,3,1,ABMrun_3.1.23_b,1,872
85,173,133,227,665,339,326,0,3,1,ABMrun_3.1.23_b,1,892
86,183,142,228,660,339,321,0,3,1,ABMrun_3.1.23_b,1,888
87,179,138,232,653,319,334,0,3,1,ABMrun_3.1.23_b,1,885
88,183,143,234,639,316,323,0,3,1,ABMrun_3.1.23_b,1,873
89,180,135,235,639,321,318,0,3,1,ABMrun_3.1.23_b,1,874
90,179,142,229,658,319,339,0,3,1,ABMrun_3.1.23_b,1,887
91,175,137,219,695,352,343,0,3,1,ABMrun_3.1.23_b,1,914
92,178,136,231,650,336,314,0,3,1,ABMrun_3.1.23_b,1,881
93,175,138,227,666,357,309,0,3,1,ABMrun_3.1.23_b,1,893
94,171,135,220,678,350,328,0,3,1,ABMrun_3.1.23_b,1,898
95,180,148,235,645,316,329,0,3,1,ABMrun_3.1.23_b,1,880
96,170,130,229,655,302,353,0,3,1,ABMrun_3.1.23_b,1,884
97,184,150,232,657,304,353,0,3,1,ABMrun_3.1.23_b,1,889
98,176,132,237,643,312,331,0,3,1,ABMrun_3.1.23_b,1,880
99,182,141,237,645,336,309,0,3,1,ABMrun_3.1.23_b,1,882
100,177,136,227,632,328,304,0,3,1,ABMrun_3.1.23_b,1,859
101,144,117,186,696,354,342,0,3,1,ABMrun_3.1.23_b,1,882
102,151,118,197,625,310,315,0,3,1,ABMrun_3.1.23_b,1,822
103,150,121,196,599,310,289,0,3,1,ABMrun_3.1.23_b,1,795
104,149,113,193,575,298,277,0,3,1,ABMrun_3.1.23_b,1,768
105,139,112,179,579,308,271,0,3,1,ABMrun_3.1.23_b,1,758
106,140,107,180,524,273,251,0,3,1,ABMrun_3.1.23_b,1,704
107,130,92,163,532,276,256,0,3,1,ABMrun_3.1.23_b,1,695
108,118,97,152,522,258,264,0,3,1,ABMrun_3.1.23_b,1,674
109,106,84,144,499,248,251,0,3,1,ABMrun_3.1.23_b,1,643
110,62,57,77,481,231,250,0,3,1,ABMrun_3.1.23_b,1,558
111,67,55,87,401,187,214,0,3,1,ABMrun_3.1.23_b,1,488
112,69,56,87,318,149,169,0,3,1,ABMrun_3.1.23_b,1,405
113,59,46,82,283,133,150,0,3,1,ABMrun_3.1.23_b,1,365
114,63,52,81,266,120,146,0,3,1,ABMrun_3.1.23_b,1,347
115,61,48,81,262,119,143,0,3,1,ABMrun_3.1.23_b,1,343
116,57,43,78,236,110,126,0,3,1,ABMrun_3.1.23_b,1,314
117,60,51,76,220,97,123,0,3,1,ABMrun_3.1.23_b,1,296
118,57,45,77,234,108,126,0,3,1,ABMrun_3.1.23_b,1,311
119,60,52,79,240,108,132,0,3,1,ABMrun_3.1.23_b,1,319
120,62,50,78,233,111,122,0,3,1,ABMrun_3.1.23_b,1,311
121,52,41,73,215,117,98,0,3,1,ABMrun_3.1.23_b,1,288
122,54,39,72,204,114,90,0,3,1,ABMrun_3.1.23_b,1,276
123,55,44,71,196,108,88,0,3,1,ABMrun_3.1.23_b,1,267
124,59,47,70,197,105,92,0,3,1,ABMrun_3.1.23_b,1,267
125,56,49,71,200,107,93,0,3,1,ABMrun_3.1.23_b,1,271
126,56,43,72,210,114,96,0,3,1,ABMrun_3.1.23_b,1,282
127,51,40,70,198,104,94,0,3,1,ABMrun_3.1.23_b,1,268
128,59,45,73,206,113,93,0,3,1,ABMrun_3.1.23_b,1,279
129,58,46,73,212,103,109,0,3,1,ABMrun_3.1.23_b,1,285
130,59,46,73,205,97,108,0,3,1,ABMrun_3.1.23_b,1,278
131,55,45,74,221,110,111,0,3,1,ABMrun_3.1.23_b,1,295
132,56,44,75,219,113,106,0,3,1,ABMrun_3.1.23_b,1,294
133,63,49,77,218,110,108,0,3,1,ABMrun_3.1.23_b,1,295
134,60,44,75,219,111,108,0,3,1,ABMrun_3.1.23_b,1,294
135,53,44,72,210,97,113,0,3,1,ABMrun_3.1.23_b,1,282
136,58,48,71,214,97,117,0,3,1,ABMrun_3.1.23_b,1,285
137,54,45,71,204,84,120,0,3,1,ABMrun_3.1.23_b,1,275
138,58,42,69,199,92,107,0,3,1,ABMrun_3.1.23_b,1,268
139,53,44,70,203,100,103,0,3,1,ABMrun_3.1.23_b,1,273
140,50,40,67,190,87,103,0,3,1,ABMrun_3.1.23_b,1,257
141,53,42,67,179,79,100,0,3,1,ABMrun_3.1.23_b,1,246
142,51,40,69,193,96,97,0,3,1,ABMrun_3.1.23_b,1,262
143,57,45,72,199,98,101,0,3,1,ABMrun_3.1.23_b,1,271
144,61,48,74,211,96,115,0,3,1,ABMrun_3.1.23_b,1,285
145,60,47,75,216,98,118,0,3,1,ABMrun_3.1.23_b,1,291
146,61,48,75,214,99,115,0,3,1,ABMrun_3.1.23_b,1,289
147,58,49,72,218,109,109,0,3,1,ABMrun_3.1.23_b,1,290
148,55,41,70,198,88,110,0,3,1,ABMrun_3.1.23_b,1,268
149,57,43,71,207,97,110,0,3,1,ABMrun_3.1.23_b,1,278
150,55,41,69,194,91,103,0,3,1,ABMrun_3.1.23_b,1,263
151,97,62,140,207,99,108,1,3,1,ABMrun_3.1.23_b,1,347
152,118,76,173,274,136,138,1,3,1,ABMrun_3.1.23_b,1,447
153,132,95,191,342,169,173,1,3,1,ABMrun_3.1.23_b,1,533
154,158,108,204,425,212,213,1,3,1,ABMrun_3.1.23_b,1,629
155,163,116,206,501,246,255,0,3,1,ABMrun_3.1.23_b,1,707
156,165,121,212,553,263,290,1,3,1,ABMrun_3.1.23_b,1,765
157,168,127,215,577,269,308,0,3,1,ABMrun_3.1.23_b,1,792
158,173,133,223,597,277,320,0,3,1,ABMrun_3.1.23_b,1,820
159,174,139,231,604,294,310,2,3,1,ABMrun_3.1.23_b,1,835
160,184,136,231,650,321,329,3,3,1,ABMrun_3.1.23_b,1,881
161,189,138,239,622,306,316,1,3,1,ABMrun_3.1.23_b,1,861
162,181,132,232,639,307,332,0,3,1,ABMrun_3.1.23_b,1,871
163,186,140,234,641,317,324,1,3,1,ABMrun_3.1.23_b,1,875
164,174,138,223,670,334,336,1,3,1,ABMrun_3.1.23_b,1,893
165,175,147,229,660,346,314,1,3,1,ABMrun_3.1.23_b,1,889
166,173,139,229,661,336,325,1,3,1,ABMrun_3.1.23_b,1,890
167,170,134,225,674,344,330,1,3,1,ABMrun_3.1.23_b,1,899
168,179,132,231,661,327,334,0,3,1,ABMrun_3.1.23_b,1,892
169,177,139,224,667,322,345,1,3,1,ABMrun_3.1.23_b,1,891
170,168,136,217,693,332,361,0,3,1,ABMrun_3.1.23_b,1,910
171,177,139,223,675,318,357,1,3,1,ABMrun_3.1.23_b,1,898
172,171,134,225,667,311,356,1,3,1,ABMrun_3.1.23_b,1,892
173,186,138,232,646,299,347,0,3,1,ABMrun_3.1.23_b,1,878
174,179,140,224,673,312,361,1,3,1,ABMrun_3.1.23_b,1,897
175,181,142,227,665,304,361,1,3,1,ABMrun_3.1.23_b,1,892
176,161,133,205,720,341,379,1,3,1,ABMrun_3.1.23_b,1,925
177,179,145,235,642,311,331,0,3,1,ABMrun_3.1.23_b,1,877
178,175,141,227,655,323,332,0,3,1,ABMrun_3.1.23_b,1,882
179,181,138,224,673,335,338,1,3,1,ABMrun_3.1.23_b,1,897
180,174,135,228,660,346,314,2,3,1,ABMrun_3.1.23_b,1,888
181,182,134,230,653,333,320,1,3,1,ABMrun_3.1.23_b,1,883
182,175,137,226,669,337,332,1,3,1,ABMrun_3.1.23_b,1,895
183,184,145,232,648,329,319,1,3,1,ABMrun_3.1.23_b,1,880
184,189,145,235,638,323,315,1,3,1,ABMrun_3.1.23_b,1,873
185,175,134,224,673,331,342,0,3,1,ABMrun_3.1.23_b,1,897
186,183,137,226,664,322,342,1,3,1,ABMrun_3.1.23_b,1,890
187,173,134,221,678,340,338,1,3,1,ABMrun_3.1.23_b,1,899
188,176,144,223,676,330,346,0,3,1,ABMrun_3.1.23_b,1,899
189,180,138,231,647,328,319,1,3,1,ABMrun_3.1.23_b,1,878
190,170,137,223,669,337,332,1,3,1,ABMrun_3.1.23_b,1,892
191,180,142,225,665,326,339,0,3,1,ABMrun_3.1.23_b,1,890
192,184,145,233,655,321,334,1,3,1,ABMrun_3.1.23_b,1,888
193,182,134,232,651,328,323,1,3,1,ABMrun_3.1.23_b,1,883
194,182,137,226,660,343,317,0,3,1,ABMrun_3.1.23_b,1,886
195,177,132,231,650,340,310,0,3,1,ABMrun_3.1.23_b,1,881
196,171,134,216,690,357,333,2,3,1,ABMrun_3.1.23_b,1,906
197,180,127,227,655,344,311,1,3,1,ABMrun_3.1.23_b,1,882
198,177,136,226,665,351,314,0,3,1,ABMrun_3.1.23_b,1,891
199,177,139,229,655,342,313,1,3,1,ABMrun_3.1.23_b,1,884
200,180,138,227,660,352,308,0,3,1,ABMrun_3.1.23_b,1,887
201,167,132,211,703,370,333,1,3,1,ABMrun_3.1.23_b,1,914
202,177,141,228,661,329,332,1,3,1,ABMrun_3.1.23_b,1,889
203,179,138,225,665,318,347,2,3,1,ABMrun_3.1.23_b,1,890
204,177,143,229,653,312,341,1,3,1,ABMrun_3.1.23_b,1,882
205,174,135,223,671,313,358,0,3,1,ABMrun_3.1.23_b,1,894
206,173,141,218,685,326,359,1,3,1,ABMrun_3.1.23_b,1,903
207,169,132,217,695,332,363,2,3,1,ABMrun_3.1.23_b,1,912
208,175,136,229,651,311,340,1,3,1,ABMrun_3.1.23_b,1,880
209,175,138,222,678,321,357,0,3,1,ABMrun_3.1.23_b,1,900
210,184,145,231,645,294,351,0,3,1,ABMrun_3.1.23_b,1,876
211,179,144,231,650,305,345,2,3,1,ABMrun_3.1.23_b,1,881
212,182,140,225,665,309,356,2,3,1,ABMrun_3.1.23_b,1,890
213,165,129,218,684,323,361,1,3,1,ABMrun_3.1.23_b,1,902
214,181,141,228,660,310,350,1,3,1,ABMrun_3.1.23_b,1,888
215,179,144,228,658,302,356,1,3,1,ABMrun_3.1.23_b,1,886
216,178,135,225,666,309,357,1,3,1,ABMrun_3.1.23_b,1,891
217,172,141,221,673,321,352,2,3,1,ABMrun_3.1.23_b,1,894
218,180,146,231,645,322,323,1,3,1,ABMrun_3.1.23_b,1,876
219,172,132,223,671,327,344,0,3,1,ABMrun_3.1.23_b,1,894
220,171,125,220,677,332,345,0,3,1,ABMrun_3.1.23_b,1,897
221,178,138,221,676,329,347,1,3,1,ABMrun_3.1.23_b,1,897
222,164,126,221,676,347,329,1,3,1,ABMrun_3.1.23_b,1,897
223,177,129,229,645,328,317,0,3,1,ABMrun_3.1.23_b,1,874
224,168,127,226,667,330,337,0,3,1,ABMrun_3.1.23_b,1,893
225,172,133,223,677,340,337,1,3,1,ABMrun_3.1.23_b,1,900
226,152,128,205,720,366,354,1,3,1,ABMrun_3.1.23_b,1,925
227,170,122,225,664,343,321,1,3,1,ABMrun_3.1.23_b,1,889
228,173,128,224,664,349,315,2,3,1,ABMrun_3.1.23_b,1,888
229,182,134,229,658,336,322,1,3,1,ABMrun_3.1.23_b,1,887
230,179,142,222,673,340,333,0,3,1,ABMrun_3.1.23_b,1,895
231,176,132,222,688,348,340,0,3,1,ABMrun_3.1.23_b,1,910
232,179,141,227,664,331,333,0,3,1,ABMrun_3.1.23_b,1,891
233,174,130,231,653,321,332,1,3,1,ABMrun_3.1.23_b,1,884
234,176,137,223,669,327,342,0,3,1,ABMrun_3.1.23_b,1,892
235,175,131,226,676,346,330,1,3,1,ABMrun_3.1.23_b,1,902
236,171,135,223,674,342,332,1,3,1,ABMrun_3.1.23_b,1,897
237,177,140,224,670,331,339,1,3,1,ABMrun_3.1.23_b,1,894
238,168,136,224,672,340,332,2,3,1,ABMrun_3.1.23_b,1,896
239,175,138,227,668,339,329,1,3,1,ABMrun_3.1.23_b,1,895
240,172,132,223,671,329,342,0,3,1,ABMrun_3.1.23_b,1,894
241,173,138,224,672,341,331,1,3,1,ABMrun_3.1.23_b,1,896
242,178,141,230,653,320,333,1,3,1,ABMrun_3.1.23_b,1,883
243,177,138,225,666,331,335,1,3,1,ABMrun_3.1.23_b,1,891
244,172,135,227,657,329,328,0,3,1,ABMrun_3.1.23_b,1,884
245,179,130,229,654,346,308,0,3,1,ABMrun_3.1.23_b,1,883
246,177,138,224,670,364,306,1,3,1,ABMrun_3.1.23_b,1,894
247,169,133,219,687,372,315,2,3,1,ABMrun_3.1.23_b,1,906
248,163,125,210,706,362,344,1,3,1,ABMrun_3.1.23_b,1,916
249,177,146,225,661,332,329,1,3,1,ABMrun_3.1.23_b,1,886
250,173,131,228,662,313,349,1,3,1,ABMrun_3.1.23_b,1,890
251,171,141,212,707,344,363,1,3,1,ABMrun_3.1.23_b,1,919
252,175,134,232,647,329,318,0,3,1,ABMrun_3.1.23_b,1,879
253,178,127,229,652,358,294,1,3,1,ABMrun_3.1.23_b,1,881
254,181,140,228,657,353,304,2,3,1,ABMrun_3.1.23_b,1,885
255,175,133,226,666,367,299,0,3,1,ABMrun_3.1.23_b,1,892
256,180,130,223,669,378,291,2,3,1,ABMrun_3.1.23_b,1,892
257,171,129,230,654,368,286,1,3,1,ABMrun_3.1.23_b,1,884
258,180,132,232,651,366,285,1,3,1,ABMrun_3.1.23_b,1,883
259,181,136,229,653,347,306,1,3,1,ABMrun_3.1.23_b,1,882
260,179,138,229,650,335,315,1,3,1,ABMrun_3.1.23_b,1,879
261,182,135,227,664,342,322,1,3,1,ABMrun_3.1.23_b,1,891
262,177,136,223,669,348,321,0,3,1,ABMrun_3.1.23_b,1,892
263,172,128,221,672,345,327,1,3,1,ABMrun_3.1.23_b,1,893
264,182,137,229,666,326,340,2,3,1,ABMrun_3.1.23_b,1,895
265,186,143,229,659,335,324,1,3,1,ABMrun_3.1.23_b,1,888
266,174,136,224,668,321,347,0,3,1,ABMrun_3.1.23_b,1,892
267,183,141,231,645,324,321,1,3,1,ABMrun_3.1.23_b,1,876
268,177,130,231,655,341,314,2,3,1,ABMrun_3.1.23_b,1,886
269,170,133,226,661,351,310,3,3,1,ABMrun_3.1.23_b,1,887
270,179,134,228,655,347,308,2,3,1,ABMrun_3.1.23_b,1,883
271,176,131,232,657,344,313,1,3,1,ABMrun_3.1.23_b,1,889
272,174,132,228,665,348,317,1,3,1,ABMrun_3.1.23_b,1,893
273,179,137,230,647,334,313,1,3,1,ABMrun_3.1.23_b,1,877
274,178,140,226,665,335,330,2,3,1,ABMrun_3.1.23_b,1,891
275,171,141,221,680,344,336,0,3,1,ABMrun_3.1.23_b,1,901
276,149,121,206,717,358,359,0,3,1,ABMrun_3.1.23_b,1,923
277,176,134,222,669,330,339,2,3,1,ABMrun_3.1.23_b,1,891
278,176,131,230,655,329,326,1,3,1,ABMrun_3.1.23_b,1,885
279,183,143,229,652,334,318,0,3,1,ABMrun_3.1.23_b,1,881
280,173,139,217,686,326,360,3,3,1,ABMrun_3.1.23_b,1,903
281,168,132,218,684,329,355,1,3,1,ABMrun_3.1.23_b,1,902
282,172,138,219,686,338,348,0,3,1,ABMrun_3.1.23_b,1,905
283,169,130,219,679,348,331,1,3,1,ABMrun_3.1.23_b,1,898
284,174,136,228,660,334,326,0,3,1,ABMrun_3.1.23_b,1,888
285,185,142,232,644,320,324,1,3,1,ABMrun_3.1.23_b,1,876
286,184,141,228,657,329,328,1,3,1,ABMrun_3.1.23_b,1,885
287,171,140,221,687,345,342,3,3,1,ABMrun_3.1.23_b,1,908
288,172,126,215,690,349,341,1,3,1,ABMrun_3.1.23_b,1,905
289,177,133,225,668,340,328,0,3,1,ABMrun_3.1.23_b,1,893
290,174,137,226,658,337,321,2,3,1,ABMrun_3.1.23_b,1,884
291,176,138,223,670,336,334,0,3,1,ABMrun_3.1.23_b,1,893
292,187,147,232,651,323,328,1,3,1,ABMrun_3.1.23_b,1,883
293,175,134,230,639,321,318,1,3,1,ABMrun_3.1.23_b,1,869
294,174,135,228,657,330,327,0,3,1,ABMrun_3.1.23_b,1,885
295,170,133,222,673,337,336,0,3,1,ABMrun_3.1.23_b,1,895
296,169,133,221,687,345,342,1,3,1,ABMrun_3.1.23_b,1,908
297,184,147,226,659,313,346,2,3,1,ABMrun_3.1.23_b,1,885
298,175,134,227,666,328,338,1,3,1,ABMrun_3.1.23_b,1,893
299,178,143,230,651,331,320,2,3,1,ABMrun_3.1.23_b,1,881
300,175,134,221,679,345,334,0,3,1,ABMrun_3.1.23_b,1,900
301,159,131,208,713,353,360,1,3,1,ABMrun_3.1.23_b,1,921
302,182,145,230,653,326,327,0,3,1,ABMrun_3.1.23_b,1,883
303,181,142,228,663,338,325,0,3,1,ABMrun_3.1.23_b,1,891
304,163,132,217,693,366,327,0,3,1,ABMrun_3.1.23_b,1,910
305,184,150,227,655,330,325,0,3,1,ABMrun_3.1.23_b,1,882
306,174,128,226,657,326,331,0,3,1,ABMrun_3.1.23_b,1,883
307,163,136,218,686,341,345,0,3,1,ABMrun_3.1.23_b,1,904
308,183,133,224,671,344,327,1,3,1,ABMrun_3.1.23_b,1,895
309,175,136,216,697,343,354,1,3,1,ABMrun_3.1.23_b,1,913
310,178,144,225,665,313,352,0,3,1,ABMrun_3.1.23_b,1,890
311,183,134,228,661,304,357,0,3,1,ABMrun_3.1.23_b,1,889
312,174,140,225,658,299,359,0,3,1,ABMrun_3.1.23_b,1,883
313,177,143,225,660,294,366,0,3,1,ABMrun_3.1.23_b,1,885
314,171,134,224,671,314,357,1,3,1,ABMrun_3.1.23_b,1,895
315,172,132,229,652,321,331,2,3,1,ABMrun_3.1.23_b,1,881
316,170,128,223,667,340,327,0,3,1,ABMrun_3.1.23_b,1,890
317,164,129,218,689,343,346,1,3,1,ABMrun_3.1.23_b,1,907
318,175,144,226,659,332,327,2,3,1,ABMrun_3.1.23_b,1,885
319,181,136,229,652,343,309,1,3,1,ABMrun_3.1.23_b,1,881
320,185,145,233,657,333,324,2,3,1,ABMrun_3.1.23_b,1,890
321,173,135,228,650,345,305,0,3,1,ABMrun_3.1.23_b,1,878
322,168,124,219,676,362,314,1,3,1,ABMrun_3.1.23_b,1,895
323,177,137,225,660,336,324,0,3,1,ABMrun_3.1.23_b,1,885
324,174,132,224,664,346,318,1,3,1,ABMrun_3.1.23_b,1,888
325,173,132,224,670,345,325,1,3,1,ABMrun_3.1.23_b,1,894
326,157,127,203,724,372,352,0,3,1,ABMrun_3.1.23_b,1,927
327,170,140,214,700,361,339,2,3,1,ABMrun_3.1.23_b,1,914
328,182,133,225,662,350,312,2,3,1,ABMrun_3.1.23_b,1,887
329,171,133,219,670,374,296,1,3,1,ABMrun_3.1.23_b,1,889
330,174,138,225,663,350,313,1,3,1,ABMrun_3.1.23_b,1,888
331,179,137,226,663,316,347,0,3,1,ABMrun_3.1.23_b,1,889
332,172,141,228,661,321,340,1,3,1,ABMrun_3.1.23_b,1,889
333,171,133,221,672,313,359,0,3,1,ABMrun_3.1.23_b,1,893
334,171,140,221,677,328,349,1,3,1,ABMrun_3.1.23_b,1,898
335,169,130,222,666,313,353,1,3,1,ABMrun_3.1.23_b,1,888
336,180,146,234,643,294,349,2,3,1,ABMrun_3.1.23_b,1,877
337,177,138,233,642,301,341,2,3,1,ABMrun_3.1.23_b,1,875
338,175,141,228,655,323,332,2,3,1,ABMrun_3.1.23_b,1,883
339,167,136,222,670,323,347,1,3,1,ABMrun_3.1.23_b,1,892
340,170,146,222,664,322,342,1,3,1,ABMrun_3.1.23_b,1,886
341,176,138,225,663,324,339,0,3,1,ABMrun_3.1.23_b,1,888
342,174,136,228,660,333,327,1,3,1,ABMrun_3.1.23_b,1,888
343,167,134,224,673,350,323,0,3,1,ABMrun_3.1.23_b,1,897
344,165,130,217,683,351,332,1,3,1,ABMrun_3.1.23_b,1,900
345,168,126,218,685,357,328,3,3,1,ABMrun_3.1.23_b,1,903
346,175,136,222,670,357,313,0,3,1,ABMrun_3.1.23_b,1,892
347,176,137,226,658,328,330,2,3,1,ABMrun_3.1.23_b,1,884
348,163,126,209,704,356,348,1,3,1,ABMrun_3.1.23_b,1,913
349,176,138,224,671,349,322,1,3,1,ABMrun_3.1.23_b,1,895
350,177,134,224,667,345,322,1,3,1,ABMrun_3.1.23_b,1,891
1,16,16,19,632,323,309,0,1,1,ABMrun_3.1.23_b,2,651
2,96,84,113,871,446,425,0,1,1,ABMrun_3.1.23_b,2,984
3,140,119,179,776,402,374,0,1,1,ABMrun_3.1.23_b,2,955
4,164,131,208,714,378,336,0,1,1,ABMrun_3.1.23_b,2,922
5,180,128,229,669,357,312,0,1,1,ABMrun_3.1.23_b,2,898
6,176,133,233,638,322,316,0,1,1,ABMrun_3.1.23_b,2,871
7,193,142,236,631,323,308,0,1,1,ABMrun_3.1.23_b,2,867
8,177,137,229,659,330,329,0,1,1,ABMrun_3.1.23_b,2,888
9,176,127,231,655,332,323,0,1,1,ABMrun_3.1.23_b,2,886
10,175,128,230,653,348,305,0,1,1,ABMrun_3.1.23_b,2,883
11,179,137,229,663,350,313,0,1,1,ABMrun_3.1.23_b,2,892
12,186,136,237,640,319,321,0,1,1,ABMrun_3.1.23_b,2,877
13,174,134,232,644,330,314,0,1,1,ABMrun_3.1.23_b,2,876
14,175,135,235,643,327,316,0,1,1,ABMrun_3.1.23_b,2,878
15,175,134,233,658,331,327,0,1,1,ABMrun_3.1.23_b,2,891
16,173,138,229,658,319,339,0,1,1,ABMrun_3.1.23_b,2,887
17,174,139,230,650,323,327,0,1,1,ABMrun_3.1.23_b,2,880
18,182,137,235,639,314,325,0,1,1,ABMrun_3.1.23_b,2,874
19,179,135,233,646,315,331,0,1,1,ABMrun_3.1.23_b,2,879
20,180,145,228,665,315,350,0,1,1,ABMrun_3.1.23_b,2,893
21,176,130,230,660,342,318,0,1,1,ABMrun_3.1.23_b,2,890
22,172,134,229,660,323,337,0,1,1,ABMrun_3.1.23_b,2,889
23,179,136,227,667,332,335,0,1,1,ABMrun_3.1.23_b,2,894
24,177,141,226,660,334,326,0,1,1,ABMrun_3.1.23_b,2,886
25,175,135,227,665,344,321,0,1,1,ABMrun_3.1.23_b,2,892
26,158,119,206,716,377,339,0,1,1,ABMrun_3.1.23_b,2,922
27,179,147,229,654,342,312,0,1,1,ABMrun_3.1.23_b,2,883
28,178,141,223,666,332,334,0,1,1,ABMrun_3.1.23_b,2,889
29,178,133,233,645,308,337,0,1,1,ABMrun_3.1.23_b,2,878
30,186,146,230,653,306,347,0,1,1,ABMrun_3.1.23_b,2,883
31,178,134,229,664,311,353,0,1,1,ABMrun_3.1.23_b,2,893
32,186,143,229,663,315,348,0,1,1,ABMrun_3.1.23_b,2,892
33,181,136,238,625,293,332,0,1,1,ABMrun_3.1.23_b,2,863
34,185,134,236,635,294,341,0,1,1,ABMrun_3.1.23_b,2,871
35,180,140,227,670,320,350,0,1,1,ABMrun_3.1.23_b,2,897
36,174,140,226,664,317,347,0,1,1,ABMrun_3.1.23_b,2,890
37,181,139,229,665,320,345,0,1,1,ABMrun_3.1.23_b,2,894
38,173,131,227,661,314,347,0,1,1,ABMrun_3.1.23_b,2,888
39,174,141,228,664,298,366,0,1,1,ABMrun_3.1.23_b,2,892
40,175,140,228,667,310,357,0,1,1,ABMrun_3.1.23_b,2,895
41,179,150,230,654,311,343,0,1,1,ABMrun_3.1.23_b,2,884
42,179,142,229,657,309,348,0,1,1,ABMrun_3.1.23_b,2,886
43,180,137,227,663,317,346,0,1,1,ABMrun_3.1.23_b,2,890
44,190,146,240,626,308,318,0,1,1,ABMrun_3.1.23_b,2,866
45,191,142,236,637,314,323,0,1,1,ABMrun_3.1.23_b,2,873
46,173,137,229,652,320,332,0,1,1,ABMrun_3.1.23_b,2,881
47,183,141,237,640,316,324,0,1,1,ABMrun_3.1.23_b,2,877
48,176,148,234,642,304,338,0,1,1,ABMrun_3.1.23_b,2,876
49,183,144,229,662,330,332,0,1,1,ABMrun_3.1.23_b,2,891
50,180,130,232,656,347,309,0,1,1,ABMrun_3.1.23_b,2,888
51,165,129,214,708,364,344,0,1,1,ABMrun_3.1.23_b,2,922
52,177,134,236,638,313,325,0,1,1,ABMrun_3.1.23_b,2,874
53,183,137,236,642,327,315,0,1,1,ABMrun_3.1.23_b,2,878
54,171,138,224,671,324,347,0,1,1,ABMrun_3.1.23_b,2,895
55,166,128,217,686,337,349,0,1,1,ABMrun_3.1.23_b,2,903
56,176,131,222,679,335,344,0,1,1,ABMrun_3.1.23_b,2,901
57,178,135,228,653,321,332,0,1,1,ABMrun_3.1.23_b,2,881
58,175,130,228,659,326,333,0,1,1,ABMrun_3.1.23_b,2,887
59,173,134,224,673,338,335,0,1,1,ABMrun_3.1.23_b,2,897
60,178,132,229,660,334,326,0,1,1,ABMrun_3.1.23_b,2,889
61,182,142,225,663,342,321,0,1,1,ABMrun_3.1.23_b,2,888
62,175,145,227,661,335,326,0,1,1,ABMrun_3.1.23_b,2,888
63,182,138,231,650,327,323,0,1,1,ABMrun_3.1.23_b,2,881
64,176,138,225,665,318,347,0,1,1,ABMrun_3.1.23_b,2,890
65,185,146,234,652,310,342,0,1,1,ABMrun_3.1.23_b,2,886
66,181,140,231,655,316,339,0,1,1,ABMrun_3.1.23_b,2,886
67,176,142,230,652,315,337,0,1,1,ABMrun_3.1.23_b,2,882
68,183,142,229,651,320,331,0,1,1,ABMrun_3.1.23_b,2,880
69,173,142,222,675,340,335,0,1,1,ABMrun_3.1.23_b,2,897
70,174,143,229,659,333,326,0,1,1,ABMrun_3.1.23_b,2,888
71,183,142,234,647,325,322,0,1,1,ABMrun_3.1.23_b,2,881
72,177,140,233,650,334,316,0,1,1,ABMrun_3.1.23_b,2,883
73,180,141,230,652,333,319,0,1,1,ABMrun_3.1.23_b,2,882
74,183,135,231,652,338,314,0,1,1,ABMrun_3.1.23_b,2,883
75,184,143,238,633,323,310,0,1,1,ABMrun_3.1.23_b,2,871
76,168,127,207,722,366,356,0,1,1,ABMrun_3.1.23_b,2,929
77,172,139,225,675,325,350,0,1,1,ABMrun_3.1.23_b,2,900
78,188,143,237,632,308,324,0,1,1,ABMrun_3.1.23_b,2,869
79,171,138,224,671,317,354,0,1,1,ABMrun_3.1.23_b,2,895
80,176,143,227,666,313,353,0,1,1,ABMrun_3.1.23_b,2,893
81,172,139,227,662,332,330,0,1,1,ABMrun_3.1.23_b,2,889
82,183,147,233,653,324,329,0,1,1,ABMrun_3.1.23_b,2,886
83,182,140,233,645,320,325,0,1,1,ABMrun_3.1.23_b,2,878
84,177,142,229,660,313,347,0,1,1,ABMrun_3.1.23_b,2,889
85,172,134,225,657,301,356,0,1,1,ABMrun_3.1.23_b,2,882
86,174,132,223,673,316,357,0,1,1,ABMrun_3.1.23_b,2,896
87,178,138,225,677,338,339,0,1,1,ABMrun_3.1.23_b,2,902
88,187,139,229,649,313,336,0,1,1,ABMrun_3.1.23_b,2,878
89,175,143,227,661,314,347,0,1,1,ABMrun_3.1.23_b,2,888
90,180,139,232,648,324,324,0,1,1,ABMrun_3.1.23_b,2,880
91,178,145,232,652,337,315,0,1,1,ABMrun_3.1.23_b,2,884
92,180,141,221,682,358,324,0,1,1,ABMrun_3.1.23_b,2,903
93,178,138,227,657,330,327,0,1,1,ABMrun_3.1.23_b,2,884
94,179,132,229,663,319,344,0,1,1,ABMrun_3.1.23_b,2,892
95,172,131,225,675,341,334,0,1,1,ABMrun_3.1.23_b,2,900
96,181,140,228,661,331,330,0,1,1,ABMrun_3.1.23_b,2,889
97,168,133,224,677,316,361,0,1,1,ABMrun_3.1.23_b,2,901
98,171,132,232,640,309,331,0,1,1,ABMrun_3.1.23_b,2,872
99,181,141,230,645,314,331,0,1,1,ABMrun_3.1.23_b,2,875
100,170,130,215,656,323,333,0,1,1,ABMrun_3.1.23_b,2,871
101,140,116,177,709,348,361,0,1,1,ABMrun_3.1.23_b,2,886
102,154,124,197,627,305,322,0,1,1,ABMrun_3.1.23_b,2,824
103,150,120,194,602,294,308,0,1,1,ABMrun_3.1.23_b,2,796
104,143,120,182,594,304,290,0,1,1,ABMrun_3.1.23_b,2,776
105,143,110,181,563,289,274,0,1,1,ABMrun_3.1.23_b,2,744
106,136,106,179,529,279,250,0,1,1,ABMrun_3.1.23_b,2,708
107,134,105,171,510,270,240,0,1,1,ABMrun_3.1.23_b,2,681
108,117,89,153,525,273,252,0,1,1,ABMrun_3.1.23_b,2,678
109,113,88,150,489,263,226,0,1,1,ABMrun_3.1.23_b,2,639
110,63,55,81,449,223,226,0,1,1,ABMrun_3.1.23_b,2,530
111,66,54,86,391,192,199,0,1,1,ABMrun_3.1.23_b,2,477
112,68,54,88,331,162,169,0,1,1,ABMrun_3.1.23_b,2,419
113,69,56,83,291,143,148,0,1,1,ABMrun_3.1.23_b,2,374
114,62,46,79,261,142,119,0,1,1,ABMrun_3.1.23_b,2,340
115,59,46,82,256,144,112,0,1,1,ABMrun_3.1.23_b,2,338
116,62,48,79,250,137,113,0,1,1,ABMrun_3.1.23_b,2,329
117,60,48,80,246,127,119,0,1,1,ABMrun_3.1.23_b,2,326
118,61,46,79,241,128,113,0,1,1,ABMrun_3.1.23_b,2,320
119,59,45,77,246,128,118,0,1,1,ABMrun_3.1.23_b,2,323
120,59,44,75,223,111,112,0,1,1,ABMrun_3.1.23_b,2,298
121,60,42,74,217,110,107,0,1,1,ABMrun_3.1.23_b,2,291
122,57,43,71,204,97,107,0,1,1,ABMrun_3.1.23_b,2,275
123,58,47,74,208,95,113,0,1,1,ABMrun_3.1.23_b,2,282
124,57,45,72,209,93,116,0,1,1,ABMrun_3.1.23_b,2,281
125,54,40,72,208,98,110,0,1,1,ABMrun_3.1.23_b,2,280
126,57,44,74,217,102,115,0,1,1,ABMrun_3.1.23_b,2,291
127,59,43,74,217,100,117,0,1,1,ABMrun_3.1.23_b,2,291
128,58,46,77,223,98,125,0,1,1,ABMrun_3.1.23_b,2,300
129,58,47,73,212,97,115,0,1,1,ABMrun_3.1.23_b,2,285
130,55,41,69,205,107,98,0,1,1,ABMrun_3.1.23_b,2,274
131,54,42,70,204,98,106,0,1,1,ABMrun_3.1.23_b,2,274
132,57,48,73,210,103,107,0,1,1,ABMrun_3.1.23_b,2,283
133,58,40,74,214,108,106,0,1,1,ABMrun_3.1.23_b,2,288
134,58,47,75,218,109,109,0,1,1,ABMrun_3.1.23_b,2,293
135,56,45,74,219,114,105,0,1,1,ABMrun_3.1.23_b,2,293
136,58,45,73,214,95,119,0,1,1,ABMrun_3.1.23_b,2,287
137,60,48,74,219,104,115,0,1,1,ABMrun_3.1.23_b,2,293
138,59,44,76,228,108,120,0,1,1,ABMrun_3.1.23_b,2,304
139,55,38,70,209,102,107,0,1,1,ABMrun_3.1.23_b,2,279
140,59,47,74,218,100,118,0,1,1,ABMrun_3.1.23_b,2,292
141,57,44,73,212,92,120,0,1,1,ABMrun_3.1.23_b,2,285
142,54,40,70,201,88,113,0,1,1,ABMrun_3.1.23_b,2,271
143,53,45,71,201,97,104,0,1,1,ABMrun_3.1.23_b,2,272
144,57,45,72,207,97,110,0,1,1,ABMrun_3.1.23_b,2,279
145,54,40,69,199,100,99,0,1,1,ABMrun_3.1.23_b,2,268
146,53,39,70,199,96,103,0,1,1,ABMrun_3.1.23_b,2,269
147,52,37,70,192,85,107,0,1,1,ABMrun_3.1.23_b,2,262
148,50,43,67,184,89,95,0,1,1,ABMrun_3.1.23_b,2,251
149,53,38,68,188,88,100,0,1,1,ABMrun_3.1.23_b,2,256
150,53,41,69,198,90,108,0,1,1,ABMrun_3.1.23_b,2,267
151,126,82,175,296,145,151,73,1,1,ABMrun_3.1.23_b,2,471
152,141,95,187,341,168,173,33,1,1,ABMrun_3.1.23_b,2,528
153,152,111,196,423,214,209,17,1,1,ABMrun_3.1.23_b,2,619
154,157,117,197,500,245,255,3,1,1,ABMrun_3.1.23_b,2,697
155,155,113,202,525,253,272,0,1,1,ABMrun_3.1.23_b,2,727
156,166,122,208,553,258,295,0,1,1,ABMrun_3.1.23_b,2,761
157,168,128,212,578,279,299,0,1,1,ABMrun_3.1.23_b,2,790
158,174,137,226,578,288,290,0,1,1,ABMrun_3.1.23_b,2,804
159,175,133,227,608,304,304,0,1,1,ABMrun_3.1.23_b,2,835
160,183,134,233,634,303,331,0,1,1,ABMrun_3.1.23_b,2,867
161,175,145,225,659,305,354,0,1,1,ABMrun_3.1.23_b,2,884
162,173,139,222,675,319,356,0,1,1,ABMrun_3.1.23_b,2,897
163,170,137,221,681,319,362,0,1,1,ABMrun_3.1.23_b,2,902
164,174,135,220,673,303,370,0,1,1,ABMrun_3.1.23_b,2,893
165,163,134,214,698,308,390,0,1,1,ABMrun_3.1.23_b,2,912
166,177,135,221,676,313,363,0,1,1,ABMrun_3.1.23_b,2,897
167,175,137,225,669,303,366,0,1,1,ABMrun_3.1.23_b,2,894
168,169,133,225,662,309,353,0,1,1,ABMrun_3.1.23_b,2,887
169,178,129,226,656,304,352,0,1,1,ABMrun_3.1.23_b,2,882
170,183,138,229,652,317,335,0,1,1,ABMrun_3.1.23_b,2,881
171,173,125,227,663,340,323,0,1,1,ABMrun_3.1.23_b,2,890
172,164,126,219,680,345,335,0,1,1,ABMrun_3.1.23_b,2,899
173,178,137,225,676,347,329,0,1,1,ABMrun_3.1.23_b,2,901
174,176,137,221,676,329,347,0,1,1,ABMrun_3.1.23_b,2,897
175,172,134,222,672,332,340,0,1,1,ABMrun_3.1.23_b,2,894
176,166,136,209,713,348,365,0,1,1,ABMrun_3.1.23_b,2,922
177,178,136,224,666,342,324,0,1,1,ABMrun_3.1.23_b,2,890
178,168,128,219,685,356,329,0,1,1,ABMrun_3.1.23_b,2,904
179,177,138,229,646,344,302,0,1,1,ABMrun_3.1.23_b,2,875
180,173,126,224,664,353,311,0,1,1,ABMrun_3.1.23_b,2,888
181,174,137,225,668,346,322,0,1,1,ABMrun_3.1.23_b,2,893
182,173,130,224,657,331,326,0,1,1,ABMrun_3.1.23_b,2,881
183,184,144,225,663,315,348,0,1,1,ABMrun_3.1.23_b,2,888
184,168,135,219,682,317,365,0,1,1,ABMrun_3.1.23_b,2,901
185,168,123,224,672,310,362,0,1,1,ABMrun_3.1.23_b,2,896
186,176,141,225,661,306,355,0,1,1,ABMrun_3.1.23_b,2,886
187,180,139,232,650,320,330,0,1,1,ABMrun_3.1.23_b,2,882
188,174,126,231,652,333,319,0,1,1,ABMrun_3.1.23_b,2,883
189,179,139,230,656,306,350,0,1,1,ABMrun_3.1.23_b,2,886
190,172,140,230,658,314,344,0,1,1,ABMrun_3.1.23_b,2,888
191,183,141,234,639,300,339,0,1,1,ABMrun_3.1.23_b,2,873
192,168,139,222,671,320,351,0,1,1,ABMrun_3.1.23_b,2,893
193,179,138,222,674,342,332,0,1,1,ABMrun_3.1.23_b,2,896
194,173,134,220,679,329,350,0,1,1,ABMrun_3.1.23_b,2,899
195,179,137,227,666,328,338,0,1,1,ABMrun_3.1.23_b,2,893
196,178,142,227,662,315,347,0,1,1,ABMrun_3.1.23_b,2,889
197,177,135,222,677,346,331,0,1,1,ABMrun_3.1.23_b,2,899
198,183,134,230,658,338,320,0,1,1,ABMrun_3.1.23_b,2,888
199,184,142,232,644,316,328,0,1,1,ABMrun_3.1.23_b,2,876
200,176,134,222,668,334,334,0,1,1,ABMrun_3.1.23_b,2,890
201,168,130,206,722,360,362,0,1,1,ABMrun_3.1.23_b,2,928
202,175,147,221,682,354,328,0,1,1,ABMrun_3.1.23_b,2,903
203,185,143,231,647,329,318,0,1,1,ABMrun_3.1.23_b,2,878
204,169,135,220,681,328,353,0,1,1,ABMrun_3.1.23_b,2,901
205,172,136,220,670,319,351,0,1,1,ABMrun_3.1.23_b,2,890
206,172,137,225,667,322,345,0,1,1,ABMrun_3.1.23_b,2,892
207,174,143,223,679,327,352,0,1,1,ABMrun_3.1.23_b,2,902
208,183,150,228,657,309,348,0,1,1,ABMrun_3.1.23_b,2,885
209,177,141,228,649,317,332,0,1,1,ABMrun_3.1.23_b,2,877
210,180,136,226,661,316,345,0,1,1,ABMrun_3.1.23_b,2,887
211,181,132,239,618,289,329,0,1,1,ABMrun_3.1.23_b,2,857
212,180,139,229,656,332,324,0,1,1,ABMrun_3.1.23_b,2,885
213,176,140,226,667,341,326,0,1,1,ABMrun_3.1.23_b,2,893
214,171,136,225,655,350,305,0,1,1,ABMrun_3.1.23_b,2,880
215,176,131,227,663,351,312,0,1,1,ABMrun_3.1.23_b,2,890
216,176,134,227,658,340,318,0,1,1,ABMrun_3.1.23_b,2,885
217,178,132,227,663,338,325,0,1,1,ABMrun_3.1.23_b,2,890
218,169,135,220,676,341,335,0,1,1,ABMrun_3.1.23_b,2,896
219,167,127,220,681,336,345,0,1,1,ABMrun_3.1.23_b,2,901
220,173,137,211,699,350,349,0,1,1,ABMrun_3.1.23_b,2,910
221,179,149,225,664,321,343,0,1,1,ABMrun_3.1.23_b,2,889
222,165,130,223,669,338,331,0,1,1,ABMrun_3.1.23_b,2,892
223,176,140,226,665,331,334,0,1,1,ABMrun_3.1.23_b,2,891
224,164,135,213,699,336,363,0,1,1,ABMrun_3.1.23_b,2,912
225,180,142,227,662,330,332,0,1,1,ABMrun_3.1.23_b,2,889
226,162,127,208,719,354,365,0,1,1,ABMrun_3.1.23_b,2,927
227,161,126,213,697,335,362,0,1,1,ABMrun_3.1.23_b,2,910
228,171,130,225,668,310,358,0,1,1,ABMrun_3.1.23_b,2,893
229,172,136,230,655,310,345,0,1,1,ABMrun_3.1.23_b,2,885
230,180,139,233,639,311,328,0,1,1,ABMrun_3.1.23_b,2,872
231,169,137,231,647,327,320,0,1,1,ABMrun_3.1.23_b,2,878
232,170,136,224,666,321,345,0,1,1,ABMrun_3.1.23_b,2,890
233,175,133,223,670,328,342,0,1,1,ABMrun_3.1.23_b,2,893
234,167,135,216,688,342,346,0,1,1,ABMrun_3.1.23_b,2,904
235,168,133,216,690,343,347,0,1,1,ABMrun_3.1.23_b,2,906
236,164,126,216,684,326,358,0,1,1,ABMrun_3.1.23_b,2,900
237,166,131,218,681,322,359,0,1,1,ABMrun_3.1.23_b,2,899
238,173,140,225,660,314,346,0,1,1,ABMrun_3.1.23_b,2,885
239,177,140,225,663,317,346,0,1,1,ABMrun_3.1.23_b,2,888
240,172,129,220,681,327,354,0,1,1,ABMrun_3.1.23_b,2,901
241,163,131,214,698,342,356,0,1,1,ABMrun_3.1.23_b,2,912
242,181,133,228,663,334,329,0,1,1,ABMrun_3.1.23_b,2,891
243,186,136,239,610,319,291,0,1,1,ABMrun_3.1.23_b,2,849
244,172,139,229,649,343,306,0,1,1,ABMrun_3.1.23_b,2,878
245,173,136,224,679,355,324,0,1,1,ABMrun_3.1.23_b,2,903
246,168,138,218,684,337,347,0,1,1,ABMrun_3.1.23_b,2,902
247,173,139,223,664,337,327,0,1,1,ABMrun_3.1.23_b,2,887
248,173,137,224,667,333,334,0,1,1,ABMrun_3.1.23_b,2,891
249,172,130,227,654,330,324,0,1,1,ABMrun_3.1.23_b,2,881
250,179,134,228,655,348,307,0,1,1,ABMrun_3.1.23_b,2,883
251,168,136,214,699,379,320,0,1,1,ABMrun_3.1.23_b,2,913
252,173,128,226,663,346,317,0,1,1,ABMrun_3.1.23_b,2,889
253,191,144,242,605,308,297,0,1,1,ABMrun_3.1.23_b,2,847
254,179,135,229,648,317,331,0,1,1,ABMrun_3.1.23_b,2,877
255,179,135,232,647,314,333,0,1,1,ABMrun_3.1.23_b,2,879
256,178,140,230,648,325,323,0,1,1,ABMrun_3.1.23_b,2,878
257,177,140,228,654,323,331,0,1,1,ABMrun_3.1.23_b,2,882
258,175,135,231,648,326,322,0,1,1,ABMrun_3.1.23_b,2,879
259,166,140,219,678,350,328,0,1,1,ABMrun_3.1.23_b,2,897
260,180,134,225,666,347,319,0,1,1,ABMrun_3.1.23_b,2,891
261,170,126,224,669,357,312,0,1,1,ABMrun_3.1.23_b,2,893
262,182,133,230,659,357,302,0,1,1,ABMrun_3.1.23_b,2,889
263,183,138,227,654,332,322,0,1,1,ABMrun_3.1.23_b,2,881
264,175,135,233,647,319,328,0,1,1,ABMrun_3.1.23_b,2,880
265,172,134,219,683,335,348,0,1,1,ABMrun_3.1.23_b,2,902
266,159,126,216,689,342,347,0,1,1,ABMrun_3.1.23_b,2,905
267,171,133,218,692,351,341,0,1,1,ABMrun_3.1.23_b,2,910
268,178,131,232,642,324,318,0,1,1,ABMrun_3.1.23_b,2,874
269,167,126,218,682,342,340,0,1,1,ABMrun_3.1.23_b,2,900
270,169,133,223,675,324,351,0,1,1,ABMrun_3.1.23_b,2,898
271,175,130,227,661,343,318,0,1,1,ABMrun_3.1.23_b,2,888
272,167,133,213,694,362,332,0,1,1,ABMrun_3.1.23_b,2,907
273,158,128,212,703,365,338,0,1,1,ABMrun_3.1.23_b,2,915
274,183,133,232,639,323,316,0,1,1,ABMrun_3.1.23_b,2,871
275,177,132,222,675,333,342,0,1,1,ABMrun_3.1.23_b,2,897
276,154,131,199,722,353,369,0,1,1,ABMrun_3.1.23_b,2,921
277,168,128,221,677,335,342,0,1,1,ABMrun_3.1.23_b,2,898
278,174,141,227,654,322,332,0,1,1,ABMrun_3.1.23_b,2,881
279,173,136,227,658,307,351,0,1,1,ABMrun_3.1.23_b,2,885
280,178,146,227,661,311,350,0,1,1,ABMrun_3.1.23_b,2,888
281,173,134,216,680,336,344,0,1,1,ABMrun_3.1.23_b,2,896
282,177,141,224,661,322,339,0,1,1,ABMrun_3.1.23_b,2,885
283,174,137,223,667,330,337,0,1,1,ABMrun_3.1.23_b,2,890
284,168,135,218,682,339,343,0,1,1,ABMrun_3.1.23_b,2,900
285,181,145,231,644,330,314,0,1,1,ABMrun_3.1.23_b,2,875
286,172,134,229,658,334,324,0,1,1,ABMrun_3.1.23_b,2,887
287,176,136,222,672,333,339,0,1,1,ABMrun_3.1.23_b,2,894
288,171,138,221,671,337,334,0,1,1,ABMrun_3.1.23_b,2,892
289,169,135,222,676,332,344,0,1,1,ABMrun_3.1.23_b,2,898
290,180,138,223,667,330,337,0,1,1,ABMrun_3.1.23_b,2,890
291,176,144,230,656,326,330,0,1,1,ABMrun_3.1.23_b,2,886
292,180,141,231,644,328,316,0,1,1,ABMrun_3.1.23_b,2,875
293,169,127,227,651,329,322,0,1,1,ABMrun_3.1.23_b,2,878
294,181,134,224,664,340,324,0,1,1,ABMrun_3.1.23_b,2,888
295,181,129,229,656,339,317,0,1,1,ABMrun_3.1.23_b,2,885
296,183,140,228,655,335,320,0,1,1,ABMrun_3.1.23_b,2,883
297,181,135,224,666,343,323,0,1,1,ABMrun_3.1.23_b,2,890
298,177,144,227,663,317,346,0,1,1,ABMrun_3.1.23_b,2,890
299,168,131,222,678,325,353,0,1,1,ABMrun_3.1.23_b,2,900
300,179,144,229,646,303,343,0,1,1,ABMrun_3.1.23_b,2,875
301,158,127,210,717,340,377,0,1,1,ABMrun_3.1.23_b,2,927
302,171,129,220,687,351,336,0,1,1,ABMrun_3.1.23_b,2,907
303,179,142,226,662,320,342,0,1,1,ABMrun_3.1.23_b,2,888
304,169,133,219,681,329,352,0,1,1,ABMrun_3.1.23_b,2,900
305,180,133,229,646,315,331,0,1,1,ABMrun_3.1.23_b,2,875
306,177,143,227,665,318,347,0,1,1,ABMrun_3.1.23_b,2,892
307,177,143,227,661,322,339,0,1,1,ABMrun_3.1.23_b,2,888
308,173,133,222,673,332,341,0,1,1,ABMrun_3.1.23_b,2,895
309,173,139,226,660,335,325,0,1,1,ABMrun_3.1.23_b,2,886
310,175,138,223,687,351,336,0,1,1,ABMrun_3.1.23_b,2,910
311,171,131,220,675,353,322,0,1,1,ABMrun_3.1.23_b,2,895
312,169,137,225,665,347,318,0,1,1,ABMrun_3.1.23_b,2,890
313,180,138,235,650,341,309,0,1,1,ABMrun_3.1.23_b,2,885
314,190,135,231,659,343,316,0,1,1,ABMrun_3.1.23_b,2,890
315,170,124,219,680,351,329,0,1,1,ABMrun_3.1.23_b,2,899
316,162,129,222,680,337,343,0,1,1,ABMrun_3.1.23_b,2,902
317,169,126,218,680,343,337,0,1,1,ABMrun_3.1.23_b,2,898
318,171,134,217,688,361,327,0,1,1,ABMrun_3.1.23_b,2,905
319,178,132,226,665,341,324,0,1,1,ABMrun_3.1.23_b,2,891
320,170,133,223,664,336,328,0,1,1,ABMrun_3.1.23_b,2,887
321,169,130,218,681,331,350,0,1,1,ABMrun_3.1.23_b,2,899
322,170,138,223,675,334,341,0,1,1,ABMrun_3.1.23_b,2,898
323,177,136,230,650,317,333,0,1,1,ABMrun_3.1.23_b,2,880
324,175,141,228,642,320,322,0,1,1,ABMrun_3.1.23_b,2,870
325,189,143,235,635,325,310,0,1,1,ABMrun_3.1.23_b,2,870
326,157,124,200,724,356,368,0,1,1,ABMrun_3.1.23_b,2,924
327,172,131,225,664,321,343,0,1,1,ABMrun_3.1.23_b,2,889
328,186,144,233,644,314,330,0,1,1,ABMrun_3.1.23_b,2,877
329,181,145,228,650,318,332,0,1,1,ABMrun_3.1.23_b,2,878
330,193,137,238,613,316,297,0,1,1,ABMrun_3.1.23_b,2,851
331,173,138,225,661,351,310,0,1,1,ABMrun_3.1.23_b,2,886
332,188,143,232,641,327,314,0,1,1,ABMrun_3.1.23_b,2,873
333,175,139,222,670,334,336,0,1,1,ABMrun_3.1.23_b,2,892
334,175,135,219,685,338,347,0,1,1,ABMrun_3.1.23_b,2,904
335,169,134,218,689,340,349,0,1,1,ABMrun_3.1.23_b,2,907
336,182,145,229,655,317,338,0,1,1,ABMrun_3.1.23_b,2,884
337,182,131,237,629,312,317,0,1,1,ABMrun_3.1.23_b,2,866
338,164,126,217,679,341,338,0,1,1,ABMrun_3.1.23_b,2,896
339,173,134,225,662,336,326,0,1,1,ABMrun_3.1.23_b,2,887
340,173,136,223,670,337,333,0,1,1,ABMrun_3.1.23_b,2,893
341,170,137,220,680,344,336,0,1,1,ABMrun_3.1.23_b,2,900
342,161,135,221,676,335,341,0,1,1,ABMrun_3.1.23_b,2,897
343,172,134,222,673,331,342,0,1,1,ABMrun_3.1.23_b,2,895
344,179,142,223,673,320,353,0,1,1,ABMrun_3.1.23_b,2,896
345,164,134,214,696,335,361,0,1,1,ABMrun_3.1.23_b,2,910
346,177,137,224,667,330,337,0,1,1,ABMrun_3.1.23_b,2,891
347,177,140,227,661,310,351,0,1,1,ABMrun_3.1.23_b,2,888
348,168,142,222,670,320,350,0,1,1,ABMrun_3.1.23_b,2,892
349,177,145,225,663,322,341,0,1,1,ABMrun_3.1.23_b,2,888
350,183,141,230,649,310,339,0,1,1,ABMrun_3.1.23_b,2,879
1,6,6,9,630,350,280,0,2,1,ABMrun_3.1.23_b,2,639
2,92,84,121,860,462,398,0,2,1,ABMrun_3.1.23_b,2,981
3,132,112,170,799,425,374,0,2,1,ABMrun_3.1.23_b,2,969
4,163,126,209,713,383,330,0,2,1,ABMrun_3.1.23_b,2,922
5,186,133,235,639,327,312,0,2,1,ABMrun_3.1.23_b,2,874
6,175,132,236,625,316,309,0,2,1,ABMrun_3.1.23_b,2,861
7,183,145,235,646,310,336,0,2,1,ABMrun_3.1.23_b,2,881
8,179,141,229,652,312,340,0,2,1,ABMrun_3.1.23_b,2,881
9,176,140,233,644,299,345,0,2,1,ABMrun_3.1.23_b,2,877
10,189,144,234,656,321,335,0,2,1,ABMrun_3.1.23_b,2,890
11,178,141,235,641,313,328,0,2,1,ABMrun_3.1.23_b,2,876
12,189,141,231,644,321,323,0,2,1,ABMrun_3.1.23_b,2,875
13,179,139,230,659,324,335,0,2,1,ABMrun_3.1.23_b,2,889
14,180,141,231,647,320,327,0,2,1,ABMrun_3.1.23_b,2,878
15,184,146,232,646,319,327,0,2,1,ABMrun_3.1.23_b,2,878
16,186,135,235,653,325,328,0,2,1,ABMrun_3.1.23_b,2,888
17,179,130,231,637,308,329,0,2,1,ABMrun_3.1.23_b,2,868
18,179,146,227,670,320,350,0,2,1,ABMrun_3.1.23_b,2,897
19,173,120,223,674,348,326,0,2,1,ABMrun_3.1.23_b,2,897
20,179,134,224,674,349,325,0,2,1,ABMrun_3.1.23_b,2,898
21,175,126,227,666,354,312,0,2,1,ABMrun_3.1.23_b,2,893
22,177,135,227,659,351,308,0,2,1,ABMrun_3.1.23_b,2,886
23,170,126,225,669,355,314,0,2,1,ABMrun_3.1.23_b,2,894
24,184,137,233,651,347,304,0,2,1,ABMrun_3.1.23_b,2,884
25,192,145,234,647,339,308,0,2,1,ABMrun_3.1.23_b,2,881
26,172,138,215,703,364,339,0,2,1,ABMrun_3.1.23_b,2,918
27,181,135,229,655,331,324,0,2,1,ABMrun_3.1.23_b,2,884
28,183,127,236,633,319,314,0,2,1,ABMrun_3.1.23_b,2,869
29,186,152,233,644,316,328,0,2,1,ABMrun_3.1.23_b,2,877
30,183,141,231,657,326,331,0,2,1,ABMrun_3.1.23_b,2,888
31,190,140,233,643,315,328,0,2,1,ABMrun_3.1.23_b,2,876
32,180,135,233,657,311,346,0,2,1,ABMrun_3.1.23_b,2,890
33,180,132,236,638,310,328,0,2,1,ABMrun_3.1.23_b,2,874
34,178,130,231,650,326,324,0,2,1,ABMrun_3.1.23_b,2,881
35,186,137,234,649,328,321,0,2,1,ABMrun_3.1.23_b,2,883
36,180,143,230,660,338,322,0,2,1,ABMrun_3.1.23_b,2,890
37,175,140,225,671,331,340,0,2,1,ABMrun_3.1.23_b,2,896
38,176,139,229,654,321,333,0,2,1,ABMrun_3.1.23_b,2,883
39,173,132,221,682,323,359,0,2,1,ABMrun_3.1.23_b,2,903
40,181,141,227,660,314,346,0,2,1,ABMrun_3.1.23_b,2,887
41,183,137,233,644,311,333,0,2,1,ABMrun_3.1.23_b,2,877
42,172,129,236,642,314,328,0,2,1,ABMrun_3.1.23_b,2,878
43,177,138,229,657,323,334,0,2,1,ABMrun_3.1.23_b,2,886
44,186,144,234,644,312,332,0,2,1,ABMrun_3.1.23_b,2,878
45,185,147,234,645,311,334,0,2,1,ABMrun_3.1.23_b,2,879
46,187,139,230,659,324,335,0,2,1,ABMrun_3.1.23_b,2,889
47,183,138,238,626,309,317,0,2,1,ABMrun_3.1.23_b,2,864
48,180,134,231,650,335,315,0,2,1,ABMrun_3.1.23_b,2,881
49,184,131,233,653,339,314,0,2,1,ABMrun_3.1.23_b,2,886
50,175,140,228,674,337,337,0,2,1,ABMrun_3.1.23_b,2,902
51,172,137,212,720,355,365,0,2,1,ABMrun_3.1.23_b,2,932
52,192,148,236,633,321,312,0,2,1,ABMrun_3.1.23_b,2,869
53,188,152,239,626,295,331,0,2,1,ABMrun_3.1.23_b,2,865
54,176,145,227,652,313,339,0,2,1,ABMrun_3.1.23_b,2,879
55,178,141,227,667,331,336,0,2,1,ABMrun_3.1.23_b,2,894
56,178,149,227,667,334,333,0,2,1,ABMrun_3.1.23_b,2,894
57,171,133,224,669,342,327,0,2,1,ABMrun_3.1.23_b,2,893
58,175,134,225,667,337,330,0,2,1,ABMrun_3.1.23_b,2,892
59,170,121,226,672,343,329,0,2,1,ABMrun_3.1.23_b,2,898
60,179,135,237,629,335,294,0,2,1,ABMrun_3.1.23_b,2,866
61,180,135,230,654,358,296,0,2,1,ABMrun_3.1.23_b,2,884
62,182,134,234,639,338,301,0,2,1,ABMrun_3.1.23_b,2,873
63,186,137,233,646,323,323,0,2,1,ABMrun_3.1.23_b,2,879
64,171,137,229,664,335,329,0,2,1,ABMrun_3.1.23_b,2,893
65,175,140,226,663,319,344,0,2,1,ABMrun_3.1.23_b,2,889
66,181,136,230,661,318,343,0,2,1,ABMrun_3.1.23_b,2,891
67,175,141,225,664,322,342,0,2,1,ABMrun_3.1.23_b,2,889
68,184,144,234,639,297,342,0,2,1,ABMrun_3.1.23_b,2,873
69,179,138,230,654,306,348,0,2,1,ABMrun_3.1.23_b,2,884
70,173,140,231,653,307,346,0,2,1,ABMrun_3.1.23_b,2,884
71,179,133,231,650,314,336,0,2,1,ABMrun_3.1.23_b,2,881
72,172,140,220,688,334,354,0,2,1,ABMrun_3.1.23_b,2,908
73,177,140,221,689,345,344,0,2,1,ABMrun_3.1.23_b,2,910
74,175,132,227,658,330,328,0,2,1,ABMrun_3.1.23_b,2,885
75,172,142,228,659,329,330,0,2,1,ABMrun_3.1.23_b,2,887
76,160,126,206,726,369,357,0,2,1,ABMrun_3.1.23_b,2,932
77,167,135,220,686,340,346,0,2,1,ABMrun_3.1.23_b,2,906
78,173,132,225,665,334,331,0,2,1,ABMrun_3.1.23_b,2,890
79,181,136,235,638,342,296,0,2,1,ABMrun_3.1.23_b,2,873
80,172,127,228,665,351,314,0,2,1,ABMrun_3.1.23_b,2,893
81,173,134,224,674,345,329,0,2,1,ABMrun_3.1.23_b,2,898
82,175,138,230,654,328,326,0,2,1,ABMrun_3.1.23_b,2,884
83,173,137,223,678,345,333,0,2,1,ABMrun_3.1.23_b,2,901
84,178,130,228,668,341,327,0,2,1,ABMrun_3.1.23_b,2,896
85,180,140,228,661,325,336,0,2,1,ABMrun_3.1.23_b,2,889
86,168,125,230,660,327,333,0,2,1,ABMrun_3.1.23_b,2,890
87,179,145,223,674,311,363,0,2,1,ABMrun_3.1.23_b,2,897
88,175,135,233,656,301,355,0,2,1,ABMrun_3.1.23_b,2,889
89,172,134,223,680,306,374,0,2,1,ABMrun_3.1.23_b,2,903
90,180,145,225,672,313,359,0,2,1,ABMrun_3.1.23_b,2,897
91,178,136,230,658,323,335,0,2,1,ABMrun_3.1.23_b,2,888
92,180,124,232,655,343,312,0,2,1,ABMrun_3.1.23_b,2,887
93,185,142,230,654,358,296,0,2,1,ABMrun_3.1.23_b,2,884
94,180,139,233,647,348,299,0,2,1,ABMrun_3.1.23_b,2,880
95,183,139,230,658,354,304,0,2,1,ABMrun_3.1.23_b,2,888
96,180,133,232,650,344,306,0,2,1,ABMrun_3.1.23_b,2,882
97,177,141,227,650,336,314,0,2,1,ABMrun_3.1.23_b,2,877
98,180,139,226,664,345,319,0,2,1,ABMrun_3.1.23_b,2,890
99,181,139,233,644,346,298,0,2,1,ABMrun_3.1.23_b,2,877
100,163,133,214,655,348,307,0,2,1,ABMrun_3.1.23_b,2,869
101,147,112,186,697,381,316,0,2,1,ABMrun_3.1.23_b,2,883
102,148,117,190,648,345,303,0,2,1,ABMrun_3.1.23_b,2,838
103,155,120,195,601,319,282,0,2,1,ABMrun_3.1.23_b,2,796
104,148,118,183,592,307,285,0,2,1,ABMrun_3.1.23_b,2,775
105,138,107,184,549,270,279,0,2,1,ABMrun_3.1.23_b,2,733
106,141,112,178,522,254,268,0,2,1,ABMrun_3.1.23_b,2,700
107,126,102,171,514,250,264,0,2,1,ABMrun_3.1.23_b,2,685
108,128,96,163,494,231,263,0,2,1,ABMrun_3.1.23_b,2,657
109,117,96,151,489,216,273,0,2,1,ABMrun_3.1.23_b,2,640
110,59,50,79,462,215,247,0,2,1,ABMrun_3.1.23_b,2,541
111,69,57,87,373,185,188,0,2,1,ABMrun_3.1.23_b,2,460
112,67,53,85,324,155,169,0,2,1,ABMrun_3.1.23_b,2,409
113,71,59,86,287,131,156,0,2,1,ABMrun_3.1.23_b,2,373
114,60,50,82,265,122,143,0,2,1,ABMrun_3.1.23_b,2,347
115,60,46,80,251,117,134,0,2,1,ABMrun_3.1.23_b,2,331
116,63,50,78,240,116,124,0,2,1,ABMrun_3.1.23_b,2,318
117,61,49,79,247,127,120,0,2,1,ABMrun_3.1.23_b,2,326
118,59,44,77,223,117,106,0,2,1,ABMrun_3.1.23_b,2,300
119,59,46,76,227,121,106,0,2,1,ABMrun_3.1.23_b,2,303
120,60,46,78,230,113,117,0,2,1,ABMrun_3.1.23_b,2,308
121,59,46,73,215,106,109,0,2,1,ABMrun_3.1.23_b,2,288
122,57,44,73,211,116,95,0,2,1,ABMrun_3.1.23_b,2,284
123,55,43,70,206,114,92,0,2,1,ABMrun_3.1.23_b,2,276
124,57,38,71,203,107,96,0,2,1,ABMrun_3.1.23_b,2,274
125,58,41,73,205,100,105,0,2,1,ABMrun_3.1.23_b,2,278
126,61,50,75,225,107,118,0,2,1,ABMrun_3.1.23_b,2,300
127,58,48,72,206,97,109,0,2,1,ABMrun_3.1.23_b,2,278
128,59,44,76,216,105,111,0,2,1,ABMrun_3.1.23_b,2,292
129,54,45,74,214,104,110,0,2,1,ABMrun_3.1.23_b,2,288
130,59,45,71,209,106,103,0,2,1,ABMrun_3.1.23_b,2,280
131,57,41,73,209,109,100,0,2,1,ABMrun_3.1.23_b,2,282
132,53,40,68,204,105,99,0,2,1,ABMrun_3.1.23_b,2,272
133,54,40,72,212,110,102,0,2,1,ABMrun_3.1.23_b,2,284
134,55,41,69,204,108,96,0,2,1,ABMrun_3.1.23_b,2,273
135,51,41,68,193,94,99,0,2,1,ABMrun_3.1.23_b,2,261
136,57,40,69,195,95,100,0,2,1,ABMrun_3.1.23_b,2,264
137,49,36,64,178,92,86,0,2,1,ABMrun_3.1.23_b,2,242
138,53,46,68,187,88,99,0,2,1,ABMrun_3.1.23_b,2,255
139,56,38,69,195,91,104,0,2,1,ABMrun_3.1.23_b,2,264
140,54,44,71,198,91,107,0,2,1,ABMrun_3.1.23_b,2,269
141,57,44,71,196,88,108,0,2,1,ABMrun_3.1.23_b,2,267
142,52,41,68,194,85,109,0,2,1,ABMrun_3.1.23_b,2,262
143,54,39,71,192,86,106,0,2,1,ABMrun_3.1.23_b,2,263
144,58,48,74,203,90,113,0,2,1,ABMrun_3.1.23_b,2,277
145,60,43,72,212,94,118,0,2,1,ABMrun_3.1.23_b,2,284
146,55,43,73,209,99,110,0,2,1,ABMrun_3.1.23_b,2,282
147,62,47,74,221,108,113,0,2,1,ABMrun_3.1.23_b,2,295
148,54,43,72,208,105,103,0,2,1,ABMrun_3.1.23_b,2,280
149,57,46,75,220,114,106,0,2,1,ABMrun_3.1.23_b,2,295
150,57,43,72,214,111,103,0,2,1,ABMrun_3.1.23_b,2,286
151,114,70,164,251,133,118,16,2,1,ABMrun_3.1.23_b,2,415
152,137,90,184,327,181,146,13,2,1,ABMrun_3.1.23_b,2,511
153,157,106,198,394,211,183,4,2,1,ABMrun_3.1.23_b,2,592
154,156,115,202,478,243,235,0,2,1,ABMrun_3.1.23_b,2,680
155,155,113,200,544,274,270,0,2,1,ABMrun_3.1.23_b,2,744
156,160,133,206,557,284,273,0,2,1,ABMrun_3.1.23_b,2,763
157,167,122,213,583,305,278,0,2,1,ABMrun_3.1.23_b,2,796
158,180,142,227,577,287,290,0,2,1,ABMrun_3.1.23_b,2,804
159,185,141,234,596,271,325,0,2,1,ABMrun_3.1.23_b,2,830
160,183,140,242,614,280,334,0,2,1,ABMrun_3.1.23_b,2,856
161,182,139,231,649,299,350,0,2,1,ABMrun_3.1.23_b,2,880
162,178,138,217,694,332,362,0,2,1,ABMrun_3.1.23_b,2,911
163,175,137,224,669,320,349,0,2,1,ABMrun_3.1.23_b,2,893
164,175,135,224,668,324,344,0,2,1,ABMrun_3.1.23_b,2,892
165,171,135,222,681,341,340,10,2,1,ABMrun_3.1.23_b,2,903
166,179,140,227,655,325,330,5,2,1,ABMrun_3.1.23_b,2,882
167,163,127,217,687,355,332,7,2,1,ABMrun_3.1.23_b,2,904
168,170,130,218,681,355,326,2,2,1,ABMrun_3.1.23_b,2,899
169,172,131,223,669,338,331,0,2,1,ABMrun_3.1.23_b,2,892
170,178,137,229,663,344,319,0,2,1,ABMrun_3.1.23_b,2,892
171,173,143,218,686,345,341,0,2,1,ABMrun_3.1.23_b,2,904
172,179,143,225,666,345,321,0,2,1,ABMrun_3.1.23_b,2,891
173,164,133,214,697,367,330,0,2,1,ABMrun_3.1.23_b,2,911
174,178,135,221,674,350,324,0,2,1,ABMrun_3.1.23_b,2,895
175,176,133,229,662,320,342,0,2,1,ABMrun_3.1.23_b,2,891
176,168,134,210,714,346,368,0,2,1,ABMrun_3.1.23_b,2,924
177,181,142,227,660,310,350,0,2,1,ABMrun_3.1.23_b,2,887
178,175,129,231,653,308,345,0,2,1,ABMrun_3.1.23_b,2,884
179,188,150,234,649,311,338,0,2,1,ABMrun_3.1.23_b,2,883
180,172,140,225,674,336,338,0,2,1,ABMrun_3.1.23_b,2,899
181,151,130,209,702,358,344,10,2,1,ABMrun_3.1.23_b,2,911
182,182,138,228,660,331,329,4,2,1,ABMrun_3.1.23_b,2,888
183,183,142,230,643,324,319,3,2,1,ABMrun_3.1.23_b,2,873
184,163,129,225,662,337,325,1,2,1,ABMrun_3.1.23_b,2,887
185,167,131,214,693,347,346,2,2,1,ABMrun_3.1.23_b,2,907
186,180,142,228,667,333,334,0,2,1,ABMrun_3.1.23_b,2,895
187,179,137,231,646,325,321,0,2,1,ABMrun_3.1.23_b,2,877
188,183,131,233,640,320,320,0,2,1,ABMrun_3.1.23_b,2,873
189,171,135,222,675,336,339,0,2,1,ABMrun_3.1.23_b,2,897
190,183,143,229,668,345,323,0,2,1,ABMrun_3.1.23_b,2,897
191,169,132,224,676,350,326,0,2,1,ABMrun_3.1.23_b,2,900
192,178,140,227,657,336,321,0,2,1,ABMrun_3.1.23_b,2,884
193,179,138,229,654,335,319,0,2,1,ABMrun_3.1.23_b,2,883
194,181,136,236,636,334,302,0,2,1,ABMrun_3.1.23_b,2,872
195,164,126,210,707,372,335,6,2,1,ABMrun_3.1.23_b,2,917
196,171,125,221,680,368,312,3,2,1,ABMrun_3.1.23_b,2,901
197,172,137,217,685,365,320,1,2,1,ABMrun_3.1.23_b,2,902
198,182,134,235,629,322,307,1,2,1,ABMrun_3.1.23_b,2,864
199,177,133,234,629,307,322,0,2,1,ABMrun_3.1.23_b,2,863
200,175,137,225,666,323,343,0,2,1,ABMrun_3.1.23_b,2,891
201,158,132,203,731,358,373,0,2,1,ABMrun_3.1.23_b,2,934
202,174,141,231,651,325,326,0,2,1,ABMrun_3.1.23_b,2,882
203,184,139,235,631,307,324,0,2,1,ABMrun_3.1.23_b,2,866
204,183,134,236,638,304,334,0,2,1,ABMrun_3.1.23_b,2,874
205,174,141,231,652,309,343,0,2,1,ABMrun_3.1.23_b,2,883
206,182,137,235,636,299,337,0,2,1,ABMrun_3.1.23_b,2,871
207,177,135,224,674,315,359,0,2,1,ABMrun_3.1.23_b,2,898
208,185,145,230,650,309,341,0,2,1,ABMrun_3.1.23_b,2,880
209,178,130,225,669,331,338,0,2,1,ABMrun_3.1.23_b,2,894
210,180,143,224,672,324,348,0,2,1,ABMrun_3.1.23_b,2,896
211,169,136,216,687,336,351,0,2,1,ABMrun_3.1.23_b,2,903
212,171,140,218,687,337,350,0,2,1,ABMrun_3.1.23_b,2,905
213,163,128,217,686,343,343,0,2,1,ABMrun_3.1.23_b,2,903
214,175,135,228,668,322,346,0,2,1,ABMrun_3.1.23_b,2,896
215,175,139,227,664,340,324,0,2,1,ABMrun_3.1.23_b,2,891
216,176,131,227,654,325,329,0,2,1,ABMrun_3.1.23_b,2,881
217,179,141,226,662,335,327,0,2,1,ABMrun_3.1.23_b,2,888
218,174,131,228,658,325,333,0,2,1,ABMrun_3.1.23_b,2,886
219,172,135,228,656,328,328,0,2,1,ABMrun_3.1.23_b,2,884
220,175,145,227,662,346,316,0,2,1,ABMrun_3.1.23_b,2,889
221,176,126,224,666,342,324,0,2,1,ABMrun_3.1.23_b,2,890
222,178,141,229,649,322,327,0,2,1,ABMrun_3.1.23_b,2,878
223,178,134,229,645,312,333,0,2,1,ABMrun_3.1.23_b,2,874
224,174,140,225,669,320,349,0,2,1,ABMrun_3.1.23_b,2,894
225,173,140,223,678,324,354,0,2,1,ABMrun_3.1.23_b,2,901
226,157,124,209,716,340,376,0,2,1,ABMrun_3.1.23_b,2,925
227,182,133,232,643,311,332,0,2,1,ABMrun_3.1.23_b,2,875
228,183,140,231,654,300,354,0,2,1,ABMrun_3.1.23_b,2,885
229,181,146,228,660,299,361,0,2,1,ABMrun_3.1.23_b,2,888
230,173,144,224,666,311,355,0,2,1,ABMrun_3.1.23_b,2,890
231,172,135,222,678,339,339,0,2,1,ABMrun_3.1.23_b,2,900
232,175,140,230,650,296,354,0,2,1,ABMrun_3.1.23_b,2,880
233,179,136,229,654,316,338,0,2,1,ABMrun_3.1.23_b,2,883
234,179,141,236,632,299,333,0,2,1,ABMrun_3.1.23_b,2,868
235,183,135,231,650,333,317,0,2,1,ABMrun_3.1.23_b,2,881
236,184,138,229,658,327,331,0,2,1,ABMrun_3.1.23_b,2,887
237,172,141,223,670,339,331,0,2,1,ABMrun_3.1.23_b,2,893
238,182,142,234,648,334,314,0,2,1,ABMrun_3.1.23_b,2,882
239,169,137,221,692,352,340,0,2,1,ABMrun_3.1.23_b,2,913
240,178,138,225,664,326,338,0,2,1,ABMrun_3.1.23_b,2,889
241,178,135,231,651,320,331,0,2,1,ABMrun_3.1.23_b,2,882
242,187,133,235,637,318,319,0,2,1,ABMrun_3.1.23_b,2,872
243,178,135,232,653,318,335,0,2,1,ABMrun_3.1.23_b,2,885
244,174,137,224,675,332,343,0,2,1,ABMrun_3.1.23_b,2,899
245,164,134,218,687,346,341,0,2,1,ABMrun_3.1.23_b,2,905
246,180,143,223,669,321,348,0,2,1,ABMrun_3.1.23_b,2,892
247,174,139,222,671,310,361,0,2,1,ABMrun_3.1.23_b,2,893
248,167,128,224,670,310,360,0,2,1,ABMrun_3.1.23_b,2,894
249,175,127,222,675,301,374,0,2,1,ABMrun_3.1.23_b,2,897
250,177,131,228,662,309,353,0,2,1,ABMrun_3.1.23_b,2,890
251,168,142,214,701,334,367,0,2,1,ABMrun_3.1.23_b,2,915
252,167,136,212,700,341,359,0,2,1,ABMrun_3.1.23_b,2,912
253,177,130,228,658,332,326,0,2,1,ABMrun_3.1.23_b,2,886
254,178,138,229,658,335,323,0,2,1,ABMrun_3.1.23_b,2,887
255,168,135,218,684,352,332,0,2,1,ABMrun_3.1.23_b,2,902
256,194,139,235,635,333,302,0,2,1,ABMrun_3.1.23_b,2,870
257,181,143,237,633,322,311,0,2,1,ABMrun_3.1.23_b,2,870
258,171,136,219,678,343,335,0,2,1,ABMrun_3.1.23_b,2,897
259,181,137,225,664,331,333,0,2,1,ABMrun_3.1.23_b,2,889
260,172,135,228,658,321,337,0,2,1,ABMrun_3.1.23_b,2,886
261,176,133,222,680,340,340,0,2,1,ABMrun_3.1.23_b,2,902
262,171,131,222,678,342,336,0,2,1,ABMrun_3.1.23_b,2,900
263,183,138,235,642,330,312,0,2,1,ABMrun_3.1.23_b,2,877
264,182,135,235,633,314,319,0,2,1,ABMrun_3.1.23_b,2,868
265,172,136,221,679,349,330,0,2,1,ABMrun_3.1.23_b,2,900
266,184,142,228,659,331,328,0,2,1,ABMrun_3.1.23_b,2,887
267,180,141,231,642,312,330,0,2,1,ABMrun_3.1.23_b,2,873
268,180,139,228,660,324,336,0,2,1,ABMrun_3.1.23_b,2,888
269,174,133,225,672,324,348,0,2,1,ABMrun_3.1.23_b,2,897
270,176,138,230,645,298,347,0,2,1,ABMrun_3.1.23_b,2,875
271,190,140,235,640,309,331,0,2,1,ABMrun_3.1.23_b,2,875
272,169,129,227,655,312,343,0,2,1,ABMrun_3.1.23_b,2,882
273,178,139,229,667,317,350,0,2,1,ABMrun_3.1.23_b,2,896
274,173,137,228,655,303,352,0,2,1,ABMrun_3.1.23_b,2,883
275,163,129,207,710,340,370,0,2,1,ABMrun_3.1.23_b,2,917
276,155,131,204,724,350,374,0,2,1,ABMrun_3.1.23_b,2,928
277,177,135,228,654,318,336,0,2,1,ABMrun_3.1.23_b,2,882
278,182,132,234,637,309,328,0,2,1,ABMrun_3.1.23_b,2,871
279,190,139,233,637,324,313,0,2,1,ABMrun_3.1.23_b,2,870
280,173,140,229,651,341,310,0,2,1,ABMrun_3.1.23_b,2,880
281,180,132,233,636,337,299,0,2,1,ABMrun_3.1.23_b,2,869
282,179,143,226,660,334,326,0,2,1,ABMrun_3.1.23_b,2,886
283,176,138,235,635,314,321,0,2,1,ABMrun_3.1.23_b,2,870
284,175,143,229,662,317,345,0,2,1,ABMrun_3.1.23_b,2,891
285,183,146,230,656,320,336,0,2,1,ABMrun_3.1.23_b,2,886
286,177,143,222,678,350,328,0,2,1,ABMrun_3.1.23_b,2,900
287,177,134,228,659,351,308,0,2,1,ABMrun_3.1.23_b,2,887
288,180,137,229,655,346,309,0,2,1,ABMrun_3.1.23_b,2,884
289,177,126,233,632,334,298,0,2,1,ABMrun_3.1.23_b,2,865
290,181,124,227,652,345,307,0,2,1,ABMrun_3.1.23_b,2,879
291,169,138,222,671,336,335,0,2,1,ABMrun_3.1.23_b,2,893
292,180,136,226,660,329,331,0,2,1,ABMrun_3.1.23_b,2,886
293,175,134,225,659,323,336,0,2,1,ABMrun_3.1.23_b,2,884
294,174,141,226,663,325,338,0,2,1,ABMrun_3.1.23_b,2,889
295,177,140,229,660,314,346,0,2,1,ABMrun_3.1.23_b,2,889
296,184,143,229,658,315,343,0,2,1,ABMrun_3.1.23_b,2,887
297,169,130,220,676,336,340,0,2,1,ABMrun_3.1.23_b,2,896
298,178,124,229,658,326,332,0,2,1,ABMrun_3.1.23_b,2,887
299,174,127,227,655,333,322,0,2,1,ABMrun_3.1.23_b,2,882
300,178,131,224,671,344,327,0,2,1,ABMrun_3.1.23_b,2,895
301,162,131,213,707,366,341,0,2,1,ABMrun_3.1.23_b,2,920
302,176,133,225,661,337,324,0,2,1,ABMrun_3.1.23_b,2,886
303,178,135,232,641,330,311,0,2,1,ABMrun_3.1.23_b,2,873
304,175,135,229,654,327,327,0,2,1,ABMrun_3.1.23_b,2,883
305,185,141,233,642,322,320,0,2,1,ABMrun_3.1.23_b,2,875
306,175,129,227,656,330,326,0,2,1,ABMrun_3.1.23_b,2,883
307,182,143,225,671,345,326,0,2,1,ABMrun_3.1.23_b,2,896
308,181,139,228,660,338,322,0,2,1,ABMrun_3.1.23_b,2,888
309,181,132,229,660,347,313,0,2,1,ABMrun_3.1.23_b,2,889
310,177,141,222,677,343,334,0,2,1,ABMrun_3.1.23_b,2,899
311,179,132,227,666,331,335,0,2,1,ABMrun_3.1.23_b,2,893
312,172,133,221,675,342,333,0,2,1,ABMrun_3.1.23_b,2,896
313,175,127,227,658,348,310,0,2,1,ABMrun_3.1.23_b,2,885
314,176,143,225,671,364,307,0,2,1,ABMrun_3.1.23_b,2,896
315,168,130,220,676,353,323,0,2,1,ABMrun_3.1.23_b,2,896
316,181,136,229,656,351,305,0,2,1,ABMrun_3.1.23_b,2,885
317,181,133,235,631,334,297,0,2,1,ABMrun_3.1.23_b,2,866
318,174,133,226,674,351,323,0,2,1,ABMrun_3.1.23_b,2,900
319,173,131,220,678,352,326,0,2,1,ABMrun_3.1.23_b,2,898
320,168,130,220,673,336,337,0,2,1,ABMrun_3.1.23_b,2,893
321,180,145,223,674,346,328,0,2,1,ABMrun_3.1.23_b,2,897
322,173,136,223,676,346,330,0,2,1,ABMrun_3.1.23_b,2,899
323,184,138,232,647,332,315,0,2,1,ABMrun_3.1.23_b,2,879
324,180,138,233,645,332,313,0,2,1,ABMrun_3.1.23_b,2,878
325,188,136,235,635,331,304,0,2,1,ABMrun_3.1.23_b,2,870
326,161,129,200,728,373,355,0,2,1,ABMrun_3.1.23_b,2,928
327,172,128,221,679,352,327,0,2,1,ABMrun_3.1.23_b,2,900
328,180,132,230,647,343,304,0,2,1,ABMrun_3.1.23_b,2,877
329,173,137,221,685,353,332,0,2,1,ABMrun_3.1.23_b,2,906
330,171,127,217,693,369,324,0,2,1,ABMrun_3.1.23_b,2,910
331,181,137,226,661,336,325,0,2,1,ABMrun_3.1.23_b,2,887
332,186,136,234,644,330,314,0,2,1,ABMrun_3.1.23_b,2,878
333,174,138,223,669,343,326,0,2,1,ABMrun_3.1.23_b,2,892
334,169,136,226,662,337,325,0,2,1,ABMrun_3.1.23_b,2,888
335,167,123,222,684,336,348,0,2,1,ABMrun_3.1.23_b,2,906
336,172,133,223,670,351,319,0,2,1,ABMrun_3.1.23_b,2,893
337,175,135,218,682,364,318,0,2,1,ABMrun_3.1.23_b,2,900
338,166,136,218,684,338,346,0,2,1,ABMrun_3.1.23_b,2,902
339,166,123,215,701,362,339,0,2,1,ABMrun_3.1.23_b,2,916
340,176,142,227,653,324,329,0,2,1,ABMrun_3.1.23_b,2,880
341,170,137,225,658,327,331,0,2,1,ABMrun_3.1.23_b,2,883
342,177,148,223,674,330,344,0,2,1,ABMrun_3.1.23_b,2,897
343,189,144,232,648,318,330,0,2,1,ABMrun_3.1.23_b,2,880
344,171,125,225,663,348,315,0,2,1,ABMrun_3.1.23_b,2,888
345,173,138,224,670,353,317,0,2,1,ABMrun_3.1.23_b,2,894
346,177,132,224,672,347,325,0,2,1,ABMrun_3.1.23_b,2,896
347,167,135,215,692,353,339,0,2,1,ABMrun_3.1.23_b,2,907
348,175,139,229,653,346,307,0,2,1,ABMrun_3.1.23_b,2,882
349,179,137,234,638,327,311,0,2,1,ABMrun_3.1.23_b,2,872
350,175,138,225,663,332,331,0,2,1,ABMrun_3.1.23_b,2,888
1,12,12,15,619,299,320,0,3,1,ABMrun_3.1.23_b,2,634
2,95,85,120,862,428,434,0,3,1,ABMrun_3.1.23_b,2,982
3,131,100,167,797,394,403,0,3,1,ABMrun_3.1.23_b,2,964
4,155,129,199,735,365,370,0,3,1,ABMrun_3.1.23_b,2,934
5,176,138,223,675,332,343,0,3,1,ABMrun_3.1.23_b,2,898
6,187,143,237,633,329,304,0,3,1,ABMrun_3.1.23_b,2,870
7,180,141,233,636,308,328,0,3,1,ABMrun_3.1.23_b,2,869
8,185,142,235,639,308,331,0,3,1,ABMrun_3.1.23_b,2,874
9,183,139,233,653,318,335,0,3,1,ABMrun_3.1.23_b,2,886
10,180,136,230,667,339,328,0,3,1,ABMrun_3.1.23_b,2,897
11,171,133,224,670,335,335,0,3,1,ABMrun_3.1.23_b,2,894
12,172,135,223,673,338,335,0,3,1,ABMrun_3.1.23_b,2,896
13,170,133,226,666,341,325,0,3,1,ABMrun_3.1.23_b,2,892
14,176,144,228,662,335,327,0,3,1,ABMrun_3.1.23_b,2,890
15,183,141,231,651,327,324,0,3,1,ABMrun_3.1.23_b,2,882
16,178,135,230,662,323,339,0,3,1,ABMrun_3.1.23_b,2,892
17,185,142,231,654,320,334,0,3,1,ABMrun_3.1.23_b,2,885
18,182,142,230,657,309,348,0,3,1,ABMrun_3.1.23_b,2,887
19,167,130,217,694,339,355,0,3,1,ABMrun_3.1.23_b,2,911
20,179,137,227,666,319,347,0,3,1,ABMrun_3.1.23_b,2,893
21,170,126,223,672,326,346,0,3,1,ABMrun_3.1.23_b,2,895
22,181,147,229,664,312,352,0,3,1,ABMrun_3.1.23_b,2,893
23,180,135,232,649,322,327,0,3,1,ABMrun_3.1.23_b,2,881
24,184,140,237,641,316,325,0,3,1,ABMrun_3.1.23_b,2,878
25,170,126,229,665,329,336,0,3,1,ABMrun_3.1.23_b,2,894
26,156,126,206,724,370,354,0,3,1,ABMrun_3.1.23_b,2,930
27,184,150,228,662,331,331,0,3,1,ABMrun_3.1.23_b,2,890
28,185,133,232,644,305,339,0,3,1,ABMrun_3.1.23_b,2,876
29,179,129,233,643,318,325,0,3,1,ABMrun_3.1.23_b,2,876
30,177,140,231,654,320,334,0,3,1,ABMrun_3.1.23_b,2,885
31,176,134,225,670,332,338,0,3,1,ABMrun_3.1.23_b,2,895
32,178,133,232,657,337,320,0,3,1,ABMrun_3.1.23_b,2,889
33,178,134,231,658,345,313,0,3,1,ABMrun_3.1.23_b,2,889
34,181,134,233,638,330,308,0,3,1,ABMrun_3.1.23_b,2,871
35,177,140,224,673,344,329,0,3,1,ABMrun_3.1.23_b,2,897
36,176,130,233,647,327,320,0,3,1,ABMrun_3.1.23_b,2,880
37,173,140,228,661,330,331,0,3,1,ABMrun_3.1.23_b,2,889
38,186,133,234,649,310,339,0,3,1,ABMrun_3.1.23_b,2,883
39,177,138,233,656,327,329,0,3,1,ABMrun_3.1.23_b,2,889
40,172,133,225,671,356,315,0,3,1,ABMrun_3.1.23_b,2,896
41,178,144,225,670,316,354,0,3,1,ABMrun_3.1.23_b,2,895
42,179,140,234,641,326,315,0,3,1,ABMrun_3.1.23_b,2,875
43,181,135,237,629,313,316,0,3,1,ABMrun_3.1.23_b,2,866
44,178,142,228,652,317,335,0,3,1,ABMrun_3.1.23_b,2,880
45,169,129,228,659,315,344,0,3,1,ABMrun_3.1.23_b,2,887
46,180,139,226,662,311,351,0,3,1,ABMrun_3.1.23_b,2,888
47,183,138,231,656,303,353,0,3,1,ABMrun_3.1.23_b,2,887
48,178,139,235,651,304,347,0,3,1,ABMrun_3.1.23_b,2,886
49,181,142,233,649,308,341,0,3,1,ABMrun_3.1.23_b,2,882
50,180,148,228,667,319,348,0,3,1,ABMrun_3.1.23_b,2,895
51,172,134,211,707,345,362,0,3,1,ABMrun_3.1.23_b,2,918
52,176,138,225,675,335,340,0,3,1,ABMrun_3.1.23_b,2,900
53,176,137,228,663,332,331,0,3,1,ABMrun_3.1.23_b,2,891
54,176,131,223,672,352,320,0,3,1,ABMrun_3.1.23_b,2,895
55,187,139,235,635,348,287,0,3,1,ABMrun_3.1.23_b,2,870
56,182,135,230,653,343,310,0,3,1,ABMrun_3.1.23_b,2,883
57,187,138,237,630,316,314,0,3,1,ABMrun_3.1.23_b,2,867
58,185,139,236,648,335,313,0,3,1,ABMrun_3.1.23_b,2,884
59,176,137,228,665,326,339,0,3,1,ABMrun_3.1.23_b,2,893
60,189,144,236,646,305,341,0,3,1,ABMrun_3.1.23_b,2,882
61,185,145,231,646,328,318,0,3,1,ABMrun_3.1.23_b,2,877
62,177,129,228,661,316,345,0,3,1,ABMrun_3.1.23_b,2,889
63,177,131,226,673,341,332,0,3,1,ABMrun_3.1.23_b,2,899
64,171,128,223,669,335,334,0,3,1,ABMrun_3.1.23_b,2,892
65,174,135,227,670,346,324,0,3,1,ABMrun_3.1.23_b,2,897
66,182,139,231,650,320,330,0,3,1,ABMrun_3.1.23_b,2,881
67,181,141,235,642,339,303,0,3,1,ABMrun_3.1.23_b,2,877
68,184,137,235,650,349,301,0,3,1,ABMrun_3.1.23_b,2,885
69,176,140,227,676,351,325,0,3,1,ABMrun_3.1.23_b,2,903
70,170,129,223,681,349,332,0,3,1,ABMrun_3.1.23_b,2,904
71,174,130,223,670,328,342,0,3,1,ABMrun_3.1.23_b,2,893
72,179,135,232,645,321,324,0,3,1,ABMrun_3.1.23_b,2,877
73,184,132,231,650,315,335,0,3,1,ABMrun_3.1.23_b,2,881
74,179,140,231,649,307,342,0,3,1,ABMrun_3.1.23_b,2,880
75,174,141,226,659,292,367,0,3,1,ABMrun_3.1.23_b,2,885
76,168,143,211,711,327,384,0,3,1,ABMrun_3.1.23_b,2,922
77,178,138,228,665,319,346,0,3,1,ABMrun_3.1.23_b,2,893
78,181,142,237,632,324,308,0,3,1,ABMrun_3.1.23_b,2,869
79,177,139,232,648,337,311,0,3,1,ABMrun_3.1.23_b,2,880
80,178,136,231,657,338,319,0,3,1,ABMrun_3.1.23_b,2,888
81,170,132,227,657,348,309,0,3,1,ABMrun_3.1.23_b,2,884
82,181,132,230,661,340,321,0,3,1,ABMrun_3.1.23_b,2,891
83,181,141,229,654,312,342,0,3,1,ABMrun_3.1.23_b,2,883
84,175,131,230,654,308,346,0,3,1,ABMrun_3.1.23_b,2,884
85,175,138,225,678,334,344,0,3,1,ABMrun_3.1.23_b,2,903
86,181,136,229,654,329,325,0,3,1,ABMrun_3.1.23_b,2,883
87,178,137,225,676,348,328,0,3,1,ABMrun_3.1.23_b,2,901
88,182,136,233,651,327,324,0,3,1,ABMrun_3.1.23_b,2,884
89,176,136,230,658,328,330,0,3,1,ABMrun_3.1.23_b,2,888
90,176,140,233,645,325,320,0,3,1,ABMrun_3.1.23_b,2,878
91,182,141,234,632,306,326,0,3,1,ABMrun_3.1.23_b,2,866
92,176,128,228,669,336,333,0,3,1,ABMrun_3.1.23_b,2,897
93,171,132,228,660,351,309,0,3,1,ABMrun_3.1.23_b,2,888
94,177,136,226,669,375,294,0,3,1,ABMrun_3.1.23_b,2,895
95,183,137,229,661,370,291,0,3,1,ABMrun_3.1.23_b,2,890
96,173,137,223,677,363,314,0,3,1,ABMrun_3.1.23_b,2,900
97,181,137,226,664,346,318,0,3,1,ABMrun_3.1.23_b,2,890
98,179,132,233,646,334,312,0,3,1,ABMrun_3.1.23_b,2,879
99,177,144,226,673,340,333,0,3,1,ABMrun_3.1.23_b,2,899
100,171,139,223,643,334,309,0,3,1,ABMrun_3.1.23_b,2,866
101,142,118,181,705,366,339,0,3,1,ABMrun_3.1.23_b,2,886
102,151,121,201,623,309,314,0,3,1,ABMrun_3.1.23_b,2,824
103,148,120,191,609,310,299,0,3,1,ABMrun_3.1.23_b,2,800
104,151,119,192,577,291,286,0,3,1,ABMrun_3.1.23_b,2,769
105,141,103,186,548,312,236,0,3,1,ABMrun_3.1.23_b,2,734
106,127,100,166,559,303,256,0,3,1,ABMrun_3.1.23_b,2,725
107,124,103,155,552,298,254,0,3,1,ABMrun_3.1.23_b,2,707
108,127,96,162,492,240,252,0,3,1,ABMrun_3.1.23_b,2,654
109,115,100,143,498,241,257,0,3,1,ABMrun_3.1.23_b,2,641
110,62,55,79,475,236,239,0,3,1,ABMrun_3.1.23_b,2,554
111,69,56,88,362,187,175,0,3,1,ABMrun_3.1.23_b,2,450
112,64,53,87,321,161,160,0,3,1,ABMrun_3.1.23_b,2,408
113,66,48,83,290,147,143,0,3,1,ABMrun_3.1.23_b,2,373
114,67,56,81,271,137,134,0,3,1,ABMrun_3.1.23_b,2,352
115,60,50,79,246,116,130,0,3,1,ABMrun_3.1.23_b,2,325
116,64,49,78,233,115,118,0,3,1,ABMrun_3.1.23_b,2,311
117,61,46,78,241,126,115,0,3,1,ABMrun_3.1.23_b,2,319
118,60,49,76,229,110,119,0,3,1,ABMrun_3.1.23_b,2,305
119,64,53,77,238,105,133,0,3,1,ABMrun_3.1.23_b,2,315
120,64,53,78,234,110,124,0,3,1,ABMrun_3.1.23_b,2,312
121,59,48,76,230,110,120,0,3,1,ABMrun_3.1.23_b,2,306
122,60,46,79,244,112,132,0,3,1,ABMrun_3.1.23_b,2,323
123,61,44,78,225,108,117,0,3,1,ABMrun_3.1.23_b,2,303
124,57,46,76,229,113,116,0,3,1,ABMrun_3.1.23_b,2,305
125,60,46,75,231,105,126,0,3,1,ABMrun_3.1.23_b,2,306
126,58,52,79,242,104,138,0,3,1,ABMrun_3.1.23_b,2,321
127,64,47,80,249,120,129,0,3,1,ABMrun_3.1.23_b,2,329
128,63,46,79,248,119,129,0,3,1,ABMrun_3.1.23_b,2,327
129,60,46,78,237,116,121,0,3,1,ABMrun_3.1.23_b,2,315
130,56,40,72,217,105,112,0,3,1,ABMrun_3.1.23_b,2,289
131,57,42,72,205,104,101,0,3,1,ABMrun_3.1.23_b,2,277
132,57,45,76,215,111,104,0,3,1,ABMrun_3.1.23_b,2,291
133,58,43,76,223,114,109,0,3,1,ABMrun_3.1.23_b,2,299
134,53,42,71,207,97,110,0,3,1,ABMrun_3.1.23_b,2,278
135,56,48,71,206,93,113,0,3,1,ABMrun_3.1.23_b,2,277
136,58,47,71,204,91,113,0,3,1,ABMrun_3.1.23_b,2,275
137,56,45,74,216,93,123,0,3,1,ABMrun_3.1.23_b,2,290
138,54,44,71,194,87,107,0,3,1,ABMrun_3.1.23_b,2,265
139,57,43,72,204,94,110,0,3,1,ABMrun_3.1.23_b,2,276
140,48,40,67,189,85,104,0,3,1,ABMrun_3.1.23_b,2,256
141,56,41,69,187,94,93,0,3,1,ABMrun_3.1.23_b,2,256
142,50,40,69,185,91,94,0,3,1,ABMrun_3.1.23_b,2,254
143,55,40,71,196,95,101,0,3,1,ABMrun_3.1.23_b,2,267
144,55,46,68,197,99,98,0,3,1,ABMrun_3.1.23_b,2,265
145,52,41,70,193,95,98,0,3,1,ABMrun_3.1.23_b,2,263
146,56,42,70,199,97,102,0,3,1,ABMrun_3.1.23_b,2,269
147,52,38,69,200,101,99,0,3,1,ABMrun_3.1.23_b,2,269
148,58,42,71,201,102,99,0,3,1,ABMrun_3.1.23_b,2,272
149,51,42,69,201,98,103,0,3,1,ABMrun_3.1.23_b,2,270
150,57,40,72,199,97,102,0,3,1,ABMrun_3.1.23_b,2,271
151,112,76,156,228,126,102,1,3,1,ABMrun_3.1.23_b,2,384
152,137,79,176,297,168,129,1,3,1,ABMrun_3.1.23_b,2,473
153,155,106,196,372,199,173,1,3,1,ABMrun_3.1.23_b,2,568
154,157,110,205,424,219,205,1,3,1,ABMrun_3.1.23_b,2,629
155,158,119,209,482,238,244,1,3,1,ABMrun_3.1.23_b,2,691
156,158,126,212,536,252,284,1,3,1,ABMrun_3.1.23_b,2,748
157,162,129,211,588,287,301,2,3,1,ABMrun_3.1.23_b,2,799
158,167,124,223,592,287,305,0,3,1,ABMrun_3.1.23_b,2,815
159,175,140,231,595,303,292,2,3,1,ABMrun_3.1.23_b,2,826
160,184,141,236,627,316,311,1,3,1,ABMrun_3.1.23_b,2,863
161,183,135,236,629,308,321,1,3,1,ABMrun_3.1.23_b,2,865
162,180,125,231,659,341,318,0,3,1,ABMrun_3.1.23_b,2,890
163,180,134,226,674,345,329,2,3,1,ABMrun_3.1.23_b,2,900
164,185,145,229,655,330,325,0,3,1,ABMrun_3.1.23_b,2,884
165,182,132,236,643,327,316,0,3,1,ABMrun_3.1.23_b,2,879
166,175,137,226,663,334,329,1,3,1,ABMrun_3.1.23_b,2,889
167,169,125,224,669,338,331,1,3,1,ABMrun_3.1.23_b,2,893
168,174,131,223,673,356,317,1,3,1,ABMrun_3.1.23_b,2,896
169,179,137,231,647,338,309,0,3,1,ABMrun_3.1.23_b,2,878
170,178,141,223,677,354,323,1,3,1,ABMrun_3.1.23_b,2,900
171,171,138,219,688,351,337,0,3,1,ABMrun_3.1.23_b,2,907
172,179,139,229,656,331,325,2,3,1,ABMrun_3.1.23_b,2,885
173,176,141,230,649,314,335,1,3,1,ABMrun_3.1.23_b,2,879
174,173,135,222,681,328,353,1,3,1,ABMrun_3.1.23_b,2,903
175,171,139,223,683,332,351,1,3,1,ABMrun_3.1.23_b,2,906
176,162,124,204,718,349,369,0,3,1,ABMrun_3.1.23_b,2,922
177,184,140,230,646,315,331,1,3,1,ABMrun_3.1.23_b,2,876
178,175,137,219,683,342,341,1,3,1,ABMrun_3.1.23_b,2,902
179,181,142,225,668,339,329,0,3,1,ABMrun_3.1.23_b,2,893
180,184,142,230,661,326,335,0,3,1,ABMrun_3.1.23_b,2,891
181,175,131,228,667,317,350,0,3,1,ABMrun_3.1.23_b,2,895
182,171,135,230,650,306,344,0,3,1,ABMrun_3.1.23_b,2,880
183,175,134,226,669,333,336,0,3,1,ABMrun_3.1.23_b,2,895
184,168,128,225,679,332,347,0,3,1,ABMrun_3.1.23_b,2,904
185,172,143,225,671,321,350,0,3,1,ABMrun_3.1.23_b,2,896
186,179,129,227,669,309,360,1,3,1,ABMrun_3.1.23_b,2,896
187,174,136,229,655,309,346,0,3,1,ABMrun_3.1.23_b,2,884
188,188,138,231,652,323,329,1,3,1,ABMrun_3.1.23_b,2,883
189,178,143,223,664,321,343,0,3,1,ABMrun_3.1.23_b,2,887
190,181,148,230,657,324,333,0,3,1,ABMrun_3.1.23_b,2,887
191,169,124,221,676,360,316,1,3,1,ABMrun_3.1.23_b,2,897
192,165,131,219,678,349,329,0,3,1,ABMrun_3.1.23_b,2,897
193,177,130,224,665,334,331,0,3,1,ABMrun_3.1.23_b,2,889
194,185,142,228,661,321,340,1,3,1,ABMrun_3.1.23_b,2,889
195,176,132,228,659,325,334,1,3,1,ABMrun_3.1.23_b,2,887
196,175,136,230,651,328,323,1,3,1,ABMrun_3.1.23_b,2,881
197,184,140,236,634,324,310,1,3,1,ABMrun_3.1.23_b,2,870
198,187,136,231,654,334,320,1,3,1,ABMrun_3.1.23_b,2,885
199,168,129,223,672,349,323,2,3,1,ABMrun_3.1.23_b,2,895
200,170,142,222,680,330,350,2,3,1,ABMrun_3.1.23_b,2,902
201,156,122,205,731,350,381,1,3,1,ABMrun_3.1.23_b,2,936
202,178,138,227,662,317,345,1,3,1,ABMrun_3.1.23_b,2,889
203,174,140,226,661,320,341,1,3,1,ABMrun_3.1.23_b,2,887
204,168,126,220,679,327,352,1,3,1,ABMrun_3.1.23_b,2,899
205,171,132,217,685,321,364,0,3,1,ABMrun_3.1.23_b,2,902
206,159,128,211,700,337,363,1,3,1,ABMrun_3.1.23_b,2,911
207,173,139,225,666,324,342,1,3,1,ABMrun_3.1.23_b,2,891
208,164,133,223,673,331,342,2,3,1,ABMrun_3.1.23_b,2,896
209,167,134,214,699,348,351,0,3,1,ABMrun_3.1.23_b,2,913
210,181,140,227,656,338,318,1,3,1,ABMrun_3.1.23_b,2,883
211,186,141,235,643,327,316,0,3,1,ABMrun_3.1.23_b,2,878
212,175,127,230,655,333,322,1,3,1,ABMrun_3.1.23_b,2,885
213,165,132,216,696,354,342,1,3,1,ABMrun_3.1.23_b,2,912
214,167,135,220,678,345,333,2,3,1,ABMrun_3.1.23_b,2,898
215,183,132,234,648,332,316,2,3,1,ABMrun_3.1.23_b,2,882
216,174,129,226,672,340,332,3,3,1,ABMrun_3.1.23_b,2,898
217,178,147,230,656,317,339,1,3,1,ABMrun_3.1.23_b,2,886
218,177,144,221,680,331,349,2,3,1,ABMrun_3.1.23_b,2,901
219,174,131,227,658,339,319,2,3,1,ABMrun_3.1.23_b,2,885
220,183,134,232,654,355,299,0,3,1,ABMrun_3.1.23_b,2,886
221,190,135,227,663,349,314,1,3,1,ABMrun_3.1.23_b,2,890
222,176,133,217,688,351,337,2,3,1,ABMrun_3.1.23_b,2,905
223,175,132,228,660,335,325,1,3,1,ABMrun_3.1.23_b,2,888
224,172,135,224,677,329,348,2,3,1,ABMrun_3.1.23_b,2,901
225,171,134,220,679,332,347,0,3,1,ABMrun_3.1.23_b,2,899
226,146,123,190,749,354,395,0,3,1,ABMrun_3.1.23_b,2,939
227,178,132,227,657,329,328,2,3,1,ABMrun_3.1.23_b,2,884
228,178,136,228,651,326,325,1,3,1,ABMrun_3.1.23_b,2,879
229,170,139,219,686,357,329,1,3,1,ABMrun_3.1.23_b,2,905
230,175,135,229,663,338,325,1,3,1,ABMrun_3.1.23_b,2,892
231,173,137,224,674,351,323,2,3,1,ABMrun_3.1.23_b,2,898
232,174,132,227,656,347,309,0,3,1,ABMrun_3.1.23_b,2,883
233,174,129,222,677,358,319,1,3,1,ABMrun_3.1.23_b,2,899
234,172,137,230,652,330,322,2,3,1,ABMrun_3.1.23_b,2,882
235,180,144,230,655,326,329,3,3,1,ABMrun_3.1.23_b,2,885
236,172,130,219,680,341,339,3,3,1,ABMrun_3.1.23_b,2,899
237,174,135,224,668,317,351,2,3,1,ABMrun_3.1.23_b,2,892
238,184,148,227,664,308,356,1,3,1,ABMrun_3.1.23_b,2,891
239,180,142,227,656,297,359,1,3,1,ABMrun_3.1.23_b,2,883
240,172,138,223,666,310,356,2,3,1,ABMrun_3.1.23_b,2,889
241,183,139,227,658,321,337,0,3,1,ABMrun_3.1.23_b,2,885
242,181,135,228,660,331,329,1,3,1,ABMrun_3.1.23_b,2,888
243,185,138,230,648,326,322,2,3,1,ABMrun_3.1.23_b,2,878
244,173,135,223,672,345,327,0,3,1,ABMrun_3.1.23_b,2,895
245,177,136,227,671,325,346,0,3,1,ABMrun_3.1.23_b,2,898
246,179,131,229,651,323,328,1,3,1,ABMrun_3.1.23_b,2,880
247,177,140,226,668,330,338,2,3,1,ABMrun_3.1.23_b,2,894
248,176,134,229,649,313,336,0,3,1,ABMrun_3.1.23_b,2,878
249,175,140,230,646,309,337,0,3,1,ABMrun_3.1.23_b,2,876
250,178,140,227,662,322,340,2,3,1,ABMrun_3.1.23_b,2,889
251,157,133,206,721,353,368,1,3,1,ABMrun_3.1.23_b,2,927
252,179,138,228,659,338,321,2,3,1,ABMrun_3.1.23_b,2,887
253,187,144,233,641,317,324,2,3,1,ABMrun_3.1.23_b,2,874
254,179,129,231,651,321,330,0,3,1,ABMrun_3.1.23_b,2,882
255,180,140,235,640,315,325,3,3,1,ABMrun_3.1.23_b,2,875
256,175,141,224,677,333,344,1,3,1,ABMrun_3.1.23_b,2,901
257,173,140,222,672,338,334,1,3,1,ABMrun_3.1.23_b,2,894
258,175,134,224,682,352,330,2,3,1,ABMrun_3.1.23_b,2,906
259,180,136,229,645,337,308,2,3,1,ABMrun_3.1.23_b,2,874
260,182,122,236,634,338,296,1,3,1,ABMrun_3.1.23_b,2,870
261,169,131,231,651,342,309,1,3,1,ABMrun_3.1.23_b,2,882
262,175,130,225,670,339,331,0,3,1,ABMrun_3.1.23_b,2,895
263,165,135,214,693,347,346,2,3,1,ABMrun_3.1.23_b,2,907
264,174,135,222,670,337,333,0,3,1,ABMrun_3.1.23_b,2,892
265,177,143,225,671,326,345,0,3,1,ABMrun_3.1.23_b,2,896
266,182,141,233,643,323,320,0,3,1,ABMrun_3.1.23_b,2,876
267,184,145,230,650,327,323,0,3,1,ABMrun_3.1.23_b,2,880
268,166,130,220,683,350,333,2,3,1,ABMrun_3.1.23_b,2,903
269,178,133,223,663,339,324,2,3,1,ABMrun_3.1.23_b,2,886
270,171,137,230,652,351,301,2,3,1,ABMrun_3.1.23_b,2,882
271,177,142,229,662,354,308,2,3,1,ABMrun_3.1.23_b,2,891
272,178,138,225,661,352,309,2,3,1,ABMrun_3.1.23_b,2,886
273,173,135,222,672,365,307,2,3,1,ABMrun_3.1.23_b,2,894
274,163,125,225,665,353,312,1,3,1,ABMrun_3.1.23_b,2,890
275,178,137,227,651,345,306,1,3,1,ABMrun_3.1.23_b,2,878
276,168,124,213,707,371,336,0,3,1,ABMrun_3.1.23_b,2,920
277,169,132,226,663,358,305,2,3,1,ABMrun_3.1.23_b,2,889
278,177,135,228,650,346,304,2,3,1,ABMrun_3.1.23_b,2,878
279,175,136,223,665,341,324,1,3,1,ABMrun_3.1.23_b,2,888
280,175,134,222,673,330,343,0,3,1,ABMrun_3.1.23_b,2,895
281,178,140,224,673,325,348,2,3,1,ABMrun_3.1.23_b,2,897
282,188,141,235,640,304,336,3,3,1,ABMrun_3.1.23_b,2,875
283,183,140,230,649,321,328,0,3,1,ABMrun_3.1.23_b,2,879
284,180,136,229,653,329,324,0,3,1,ABMrun_3.1.23_b,2,882
285,177,142,228,650,314,336,0,3,1,ABMrun_3.1.23_b,2,878
286,178,144,226,673,316,357,1,3,1,ABMrun_3.1.23_b,2,899
287,183,142,226,663,321,342,3,3,1,ABMrun_3.1.23_b,2,889
288,180,139,225,661,318,343,1,3,1,ABMrun_3.1.23_b,2,886
289,181,146,230,651,319,332,1,3,1,ABMrun_3.1.23_b,2,881
290,176,140,224,671,330,341,1,3,1,ABMrun_3.1.23_b,2,895
291,179,136,226,662,330,332,2,3,1,ABMrun_3.1.23_b,2,888
292,171,141,227,658,329,329,1,3,1,ABMrun_3.1.23_b,2,885
293,180,135,229,650,337,313,1,3,1,ABMrun_3.1.23_b,2,879
294,181,139,229,660,335,325,2,3,1,ABMrun_3.1.23_b,2,889
295,180,136,225,671,344,327,0,3,1,ABMrun_3.1.23_b,2,896
296,170,128,225,671,343,328,2,3,1,ABMrun_3.1.23_b,2,896
297,175,137,227,664,333,331,1,3,1,ABMrun_3.1.23_b,2,891
298,187,132,236,635,319,316,0,3,1,ABMrun_3.1.23_b,2,871
299,183,140,225,661,334,327,0,3,1,ABMrun_3.1.23_b,2,886
300,187,149,233,632,301,331,1,3,1,ABMrun_3.1.23_b,2,865
301,168,137,216,695,329,366,1,3,1,ABMrun_3.1.23_b,2,911
302,174,127,224,668,319,349,0,3,1,ABMrun_3.1.23_b,2,892
303,179,136,227,657,309,348,1,3,1,ABMrun_3.1.23_b,2,884
304,183,145,228,655,324,331,1,3,1,ABMrun_3.1.23_b,2,883
305,173,133,229,657,333,324,1,3,1,ABMrun_3.1.23_b,2,886
306,181,135,228,665,341,324,0,3,1,ABMrun_3.1.23_b,2,893
307,175,144,227,656,312,344,0,3,1,ABMrun_3.1.23_b,2,883
308,180,143,232,651,312,339,1,3,1,ABMrun_3.1.23_b,2,883
309,186,146,230,653,319,334,1,3,1,ABMrun_3.1.23_b,2,883
310,169,134,219,681,336,345,1,3,1,ABMrun_3.1.23_b,2,900
311,164,132,212,696,341,355,1,3,1,ABMrun_3.1.23_b,2,908
312,166,131,208,709,358,351,0,3,1,ABMrun_3.1.23_b,2,917
313,173,138,220,677,349,328,2,3,1,ABMrun_3.1.23_b,2,897
314,185,139,231,650,334,316,1,3,1,ABMrun_3.1.23_b,2,881
315,178,138,232,641,327,314,1,3,1,ABMrun_3.1.23_b,2,873
316,184,143,230,652,329,323,1,3,1,ABMrun_3.1.23_b,2,882
317,178,134,228,660,318,342,0,3,1,ABMrun_3.1.23_b,2,888
318,173,145,224,669,324,345,1,3,1,ABMrun_3.1.23_b,2,893
319,168,134,219,687,325,362,1,3,1,ABMrun_3.1.23_b,2,906
320,180,139,229,650,314,336,0,3,1,ABMrun_3.1.23_b,2,879
321,180,136,227,656,320,336,0,3,1,ABMrun_3.1.23_b,2,883
322,168,136,221,671,346,325,0,3,1,ABMrun_3.1.23_b,2,892
323,181,144,235,648,331,317,2,3,1,ABMrun_3.1.23_b,2,883
324,182,129,235,635,350,285,0,3,1,ABMrun_3.1.23_b,2,870
325,171,139,225,667,352,315,3,3,1,ABMrun_3.1.23_b,2,892
326,161,128,212,716,361,355,3,3,1,ABMrun_3.1.23_b,2,928
327,167,140,220,678,330,348,0,3,1,ABMrun_3.1.23_b,2,898
328,179,135,231,643,306,337,1,3,1,ABMrun_3.1.23_b,2,874
329,163,125,223,670,324,346,0,3,1,ABMrun_3.1.23_b,2,893
330,165,129,213,697,339,358,0,3,1,ABMrun_3.1.23_b,2,910
331,170,139,223,674,352,322,2,3,1,ABMrun_3.1.23_b,2,897
332,171,138,223,672,343,329,1,3,1,ABMrun_3.1.23_b,2,895
333,167,135,209,708,350,358,1,3,1,ABMrun_3.1.23_b,2,917
334,178,135,222,676,347,329,0,3,1,ABMrun_3.1.23_b,2,898
335,169,138,225,676,349,327,1,3,1,ABMrun_3.1.23_b,2,901
336,182,138,228,651,313,338,0,3,1,ABMrun_3.1.23_b,2,879
337,172,140,223,676,327,349,0,3,1,ABMrun_3.1.23_b,2,899
338,170,125,222,671,323,348,2,3,1,ABMrun_3.1.23_b,2,893
339,172,139,228,656,306,350,1,3,1,ABMrun_3.1.23_b,2,884
340,181,138,227,658,309,349,0,3,1,ABMrun_3.1.23_b,2,885
341,185,142,230,658,314,344,1,3,1,ABMrun_3.1.23_b,2,888
342,171,129,228,660,338,322,1,3,1,ABMrun_3.1.23_b,2,888
343,172,133,222,677,351,326,1,3,1,ABMrun_3.1.23_b,2,899
344,166,122,221,679,345,334,1,3,1,ABMrun_3.1.23_b,2,900
345,167,137,215,697,352,345,0,3,1,ABMrun_3.1.23_b,2,912
346,172,133,220,683,346,337,0,3,1,ABMrun_3.1.23_b,2,903
347,172,139,223,671,322,349,0,3,1,ABMrun_3.1.23_b,2,894
348,178,136,228,658,318,340,1,3,1,ABMrun_3.1.23_b,2,886
349,176,130,224,671,333,338,1,3,1,ABMrun_3.1.23_b,2,895
350,165,127,214,691,333,358,0,3,1,ABMrun_3.1.23_b,2,905
1,9,9,12,611,320,291,0,1,1,ABMrun_3.1.23_b,3,623
2,81,71,104,881,461,420,0,1,1,ABMrun_3.1.23_b,3,985
3,122,107,160,803,418,385,0,1,1,ABMrun_3.1.23_b,3,963
4,167,128,207,721,382,339,0,1,1,ABMrun_3.1.23_b,3,928
5,181,146,233,655,323,332,0,1,1,ABMrun_3.1.23_b,3,888
6,184,136,237,631,306,325,0,1,1,ABMrun_3.1.23_b,3,868
7,183,138,236,619,278,341,0,1,1,ABMrun_3.1.23_b,3,855
8,184,148,237,639,305,334,0,1,1,ABMrun_3.1.23_b,3,876
9,188,140,237,639,315,324,0,1,1,ABMrun_3.1.23_b,3,876
10,186,142,240,617,296,321,0,1,1,ABMrun_3.1.23_b,3,857
11,187,139,235,640,307,333,0,1,1,ABMrun_3.1.23_b,3,875
12,181,133,231,641,296,345,0,1,1,ABMrun_3.1.23_b,3,872
13,177,141,232,648,307,341,0,1,1,ABMrun_3.1.23_b,3,880
14,183,148,235,632,299,333,0,1,1,ABMrun_3.1.23_b,3,867
15,185,136,230,659,320,339,0,1,1,ABMrun_3.1.23_b,3,889
16,168,129,226,672,344,328,0,1,1,ABMrun_3.1.23_b,3,898
17,177,140,222,681,347,334,0,1,1,ABMrun_3.1.23_b,3,903
18,175,128,232,663,334,329,0,1,1,ABMrun_3.1.23_b,3,895
19,181,142,233,656,325,331,0,1,1,ABMrun_3.1.23_b,3,889
20,181,133,229,668,332,336,0,1,1,ABMrun_3.1.23_b,3,897
21,186,135,233,652,330,322,0,1,1,ABMrun_3.1.23_b,3,885
22,168,127,227,666,331,335,0,1,1,ABMrun_3.1.23_b,3,893
23,173,136,227,663,336,327,0,1,1,ABMrun_3.1.23_b,3,890
24,174,127,225,668,352,316,0,1,1,ABMrun_3.1.23_b,3,893
25,177,130,221,679,355,324,0,1,1,ABMrun_3.1.23_b,3,900
26,160,128,211,720,362,358,0,1,1,ABMrun_3.1.23_b,3,931
27,176,139,226,671,329,342,0,1,1,ABMrun_3.1.23_b,3,897
28,188,139,232,647,316,331,0,1,1,ABMrun_3.1.23_b,3,879
29,182,148,234,633,308,325,0,1,1,ABMrun_3.1.23_b,3,867
30,184,138,235,633,312,321,0,1,1,ABMrun_3.1.23_b,3,868
31,185,140,233,645,329,316,0,1,1,ABMrun_3.1.23_b,3,878
32,184,139,230,650,343,307,0,1,1,ABMrun_3.1.23_b,3,880
33,167,123,225,672,340,332,0,1,1,ABMrun_3.1.23_b,3,897
34,185,134,236,626,329,297,0,1,1,ABMrun_3.1.23_b,3,862
35,179,141,235,644,310,334,0,1,1,ABMrun_3.1.23_b,3,879
36,181,134,228,660,334,326,0,1,1,ABMrun_3.1.23_b,3,888
37,190,140,237,633,325,308,0,1,1,ABMrun_3.1.23_b,3,870
38,176,127,224,670,360,310,0,1,1,ABMrun_3.1.23_b,3,894
39,173,143,224,675,346,329,0,1,1,ABMrun_3.1.23_b,3,899
40,174,135,227,656,328,328,0,1,1,ABMrun_3.1.23_b,3,883
41,180,131,237,634,333,301,0,1,1,ABMrun_3.1.23_b,3,871
42,181,144,232,649,326,323,0,1,1,ABMrun_3.1.23_b,3,881
43,183,145,228,655,321,334,0,1,1,ABMrun_3.1.23_b,3,883
44,171,133,225,668,326,342,0,1,1,ABMrun_3.1.23_b,3,893
45,180,141,229,662,327,335,0,1,1,ABMrun_3.1.23_b,3,891
46,188,132,230,662,334,328,0,1,1,ABMrun_3.1.23_b,3,892
47,183,139,229,655,323,332,0,1,1,ABMrun_3.1.23_b,3,884
48,177,142,227,674,344,330,0,1,1,ABMrun_3.1.23_b,3,901
49,179,136,231,650,324,326,0,1,1,ABMrun_3.1.23_b,3,881
50,190,147,234,641,305,336,0,1,1,ABMrun_3.1.23_b,3,875
51,169,132,213,703,330,373,0,1,1,ABMrun_3.1.23_b,3,916
52,181,139,227,670,300,370,0,1,1,ABMrun_3.1.23_b,3,897
53,187,145,235,643,305,338,0,1,1,ABMrun_3.1.23_b,3,878
54,179,137,229,660,316,344,0,1,1,ABMrun_3.1.23_b,3,889
55,181,140,229,670,323,347,0,1,1,ABMrun_3.1.23_b,3,899
56,184,153,234,642,309,333,0,1,1,ABMrun_3.1.23_b,3,876
57,183,145,231,658,321,337,0,1,1,ABMrun_3.1.23_b,3,889
58,185,141,230,655,311,344,0,1,1,ABMrun_3.1.23_b,3,885
59,182,135,233,650,310,340,0,1,1,ABMrun_3.1.23_b,3,883
60,176,140,227,674,334,340,0,1,1,ABMrun_3.1.23_b,3,901
61,186,139,233,650,334,316,0,1,1,ABMrun_3.1.23_b,3,883
62,185,140,236,643,319,324,0,1,1,ABMrun_3.1.23_b,3,879
63,182,153,232,654,322,332,0,1,1,ABMrun_3.1.23_b,3,886
64,185,146,232,639,307,332,0,1,1,ABMrun_3.1.23_b,3,871
65,178,134,227,662,319,343,0,1,1,ABMrun_3.1.23_b,3,889
66,170,134,227,661,313,348,0,1,1,ABMrun_3.1.23_b,3,888
67,184,135,240,630,302,328,0,1,1,ABMrun_3.1.23_b,3,870
68,189,143,240,635,319,316,0,1,1,ABMrun_3.1.23_b,3,875
69,178,142,232,640,324,316,0,1,1,ABMrun_3.1.23_b,3,872
70,182,134,232,651,341,310,0,1,1,ABMrun_3.1.23_b,3,883
71,178,138,227,669,355,314,0,1,1,ABMrun_3.1.23_b,3,896
72,180,131,234,643,334,309,0,1,1,ABMrun_3.1.23_b,3,877
73,188,132,236,645,334,311,0,1,1,ABMrun_3.1.23_b,3,881
74,180,131,231,651,335,316,0,1,1,ABMrun_3.1.23_b,3,882
75,178,138,232,657,328,329,0,1,1,ABMrun_3.1.23_b,3,889
76,168,138,208,717,344,373,0,1,1,ABMrun_3.1.23_b,3,925
77,190,145,236,630,287,343,0,1,1,ABMrun_3.1.23_b,3,866
78,184,150,238,627,275,352,0,1,1,ABMrun_3.1.23_b,3,865
79,185,150,229,653,299,354,0,1,1,ABMrun_3.1.23_b,3,882
80,179,139,227,661,305,356,0,1,1,ABMrun_3.1.23_b,3,888
81,175,140,226,666,289,377,0,1,1,ABMrun_3.1.23_b,3,892
82,179,136,229,660,294,366,0,1,1,ABMrun_3.1.23_b,3,889
83,183,145,228,664,313,351,0,1,1,ABMrun_3.1.23_b,3,892
84,175,132,224,668,331,337,0,1,1,ABMrun_3.1.23_b,3,892
85,172,135,224,674,338,336,0,1,1,ABMrun_3.1.23_b,3,898
86,180,142,226,662,315,347,0,1,1,ABMrun_3.1.23_b,3,888
87,180,139,232,660,314,346,0,1,1,ABMrun_3.1.23_b,3,892
88,175,136,226,663,316,347,0,1,1,ABMrun_3.1.23_b,3,889
89,174,135,227,667,319,348,0,1,1,ABMrun_3.1.23_b,3,894
90,179,137,233,642,314,328,0,1,1,ABMrun_3.1.23_b,3,875
91,181,136,231,648,318,330,0,1,1,ABMrun_3.1.23_b,3,879
92,173,139,226,666,325,341,0,1,1,ABMrun_3.1.23_b,3,892
93,187,148,231,652,332,320,0,1,1,ABMrun_3.1.23_b,3,883
94,179,141,230,661,329,332,0,1,1,ABMrun_3.1.23_b,3,891
95,181,139,230,654,328,326,0,1,1,ABMrun_3.1.23_b,3,884
96,172,136,226,666,333,333,0,1,1,ABMrun_3.1.23_b,3,892
97,178,135,228,654,334,320,0,1,1,ABMrun_3.1.23_b,3,882
98,179,142,229,657,331,326,0,1,1,ABMrun_3.1.23_b,3,886
99,176,128,225,665,352,313,0,1,1,ABMrun_3.1.23_b,3,890
100,161,112,210,671,350,321,0,1,1,ABMrun_3.1.23_b,3,881
101,145,120,184,699,361,338,0,1,1,ABMrun_3.1.23_b,3,883
102,161,126,203,613,305,308,0,1,1,ABMrun_3.1.23_b,3,816
103,135,115,185,628,309,319,0,1,1,ABMrun_3.1.23_b,3,813
104,150,116,188,574,271,303,0,1,1,ABMrun_3.1.23_b,3,762
105,151,113,181,563,261,302,0,1,1,ABMrun_3.1.23_b,3,744
106,135,107,170,553,272,281,0,1,1,ABMrun_3.1.23_b,3,723
107,131,108,160,544,270,274,0,1,1,ABMrun_3.1.23_b,3,704
108,110,95,144,533,269,264,0,1,1,ABMrun_3.1.23_b,3,677
109,117,100,154,483,237,246,0,1,1,ABMrun_3.1.23_b,3,637
110,64,54,81,464,241,223,0,1,1,ABMrun_3.1.23_b,3,545
111,67,57,85,395,199,196,0,1,1,ABMrun_3.1.23_b,3,480
112,69,58,89,354,165,189,0,1,1,ABMrun_3.1.23_b,3,443
113,64,57,86,307,142,165,0,1,1,ABMrun_3.1.23_b,3,393
114,65,51,86,282,131,151,0,1,1,ABMrun_3.1.23_b,3,368
115,65,50,83,276,131,145,0,1,1,ABMrun_3.1.23_b,3,359
116,66,53,82,269,121,148,0,1,1,ABMrun_3.1.23_b,3,351
117,62,49,78,252,120,132,0,1,1,ABMrun_3.1.23_b,3,330
118,65,49,79,240,113,127,0,1,1,ABMrun_3.1.23_b,3,319
119,61,48,78,237,112,125,0,1,1,ABMrun_3.1.23_b,3,315
120,58,47,75,220,106,114,0,1,1,ABMrun_3.1.23_b,3,295
121,52,40,72,213,97,116,0,1,1,ABMrun_3.1.23_b,3,285
122,57,46,75,223,103,120,0,1,1,ABMrun_3.1.23_b,3,298
123,55,43,75,216,99,117,0,1,1,ABMrun_3.1.23_b,3,291
124,56,45,72,204,88,116,0,1,1,ABMrun_3.1.23_b,3,276
125,55,40,72,207,92,115,0,1,1,ABMrun_3.1.23_b,3,279
126,56,48,73,215,100,115,0,1,1,ABMrun_3.1.23_b,3,288
127,53,41,71,211,102,109,0,1,1,ABMrun_3.1.23_b,3,282
128,57,45,70,202,95,107,0,1,1,ABMrun_3.1.23_b,3,272
129,58,45,74,208,95,113,0,1,1,ABMrun_3.1.23_b,3,282
130,57,43,74,219,98,121,0,1,1,ABMrun_3.1.23_b,3,293
131,55,44,69,196,94,102,0,1,1,ABMrun_3.1.23_b,3,265
132,55,45,70,195,87,108,0,1,1,ABMrun_3.1.23_b,3,265
133,58,45,71,201,90,111,0,1,1,ABMrun_3.1.23_b,3,272
134,56,44,71,198,92,106,0,1,1,ABMrun_3.1.23_b,3,269
135,55,40,70,203,98,105,0,1,1,ABMrun_3.1.23_b,3,273
136,54,45,69,200,99,101,0,1,1,ABMrun_3.1.23_b,3,269
137,60,50,73,213,111,102,0,1,1,ABMrun_3.1.23_b,3,286
138,56,40,74,205,110,95,0,1,1,ABMrun_3.1.23_b,3,279
139,56,41,71,205,104,101,0,1,1,ABMrun_3.1.23_b,3,276
140,52,41,69,203,101,102,0,1,1,ABMrun_3.1.23_b,3,272
141,57,45,71,199,109,90,0,1,1,ABMrun_3.1.23_b,3,270
142,52,45,71,201,108,93,0,1,1,ABMrun_3.1.23_b,3,272
143,61,46,75,222,118,104,0,1,1,ABMrun_3.1.23_b,3,297
144,54,39,71,210,113,97,0,1,1,ABMrun_3.1.23_b,3,281
145,53,42,72,203,99,104,0,1,1,ABMrun_3.1.23_b,3,275
146,56,38,70,198,92,106,0,1,1,ABMrun_3.1.23_b,3,268
147,60,45,72,204,100,104,0,1,1,ABMrun_3.1.23_b,3,276
148,56,38,69,195,96,99,0,1,1,ABMrun_3.1.23_b,3,264
149,53,37,67,193,84,109,0,1,1,ABMrun_3.1.23_b,3,260
150,51,37,67,186,77,109,0,1,1,ABMrun_3.1.23_b,3,253
151,122,86,179,295,130,165,61,1,1,ABMrun_3.1.23_b,3,474
152,143,100,192,371,167,204,40,1,1,ABMrun_3.1.23_b,3,563
153,150,110,194,446,202,244,21,1,1,ABMrun_3.1.23_b,3,640
154,152,120,197,499,225,274,7,1,1,ABMrun_3.1.23_b,3,696
155,150,115,197,543,244,299,1,1,1,ABMrun_3.1.23_b,3,740
156,157,122,204,564,267,297,2,1,1,ABMrun_3.1.23_b,3,768
157,161,120,207,600,294,306,0,1,1,ABMrun_3.1.23_b,3,807
158,169,132,222,582,290,292,0,1,1,ABMrun_3.1.23_b,3,804
159,181,143,230,609,295,314,0,1,1,ABMrun_3.1.23_b,3,839
160,189,149,236,638,313,325,0,1,1,ABMrun_3.1.23_b,3,874
161,178,130,227,655,339,316,0,1,1,ABMrun_3.1.23_b,3,882
162,178,137,221,679,339,340,0,1,1,ABMrun_3.1.23_b,3,900
163,166,127,221,674,325,349,0,1,1,ABMrun_3.1.23_b,3,895
164,175,140,226,662,307,355,0,1,1,ABMrun_3.1.23_b,3,888
165,179,148,221,677,317,360,0,1,1,ABMrun_3.1.23_b,3,898
166,173,136,218,679,329,350,0,1,1,ABMrun_3.1.23_b,3,897
167,178,138,224,679,343,336,0,1,1,ABMrun_3.1.23_b,3,903
168,169,127,223,664,349,315,0,1,1,ABMrun_3.1.23_b,3,887
169,180,141,226,660,349,311,0,1,1,ABMrun_3.1.23_b,3,886
170,170,133,224,676,352,324,0,1,1,ABMrun_3.1.23_b,3,900
171,177,138,225,666,332,334,0,1,1,ABMrun_3.1.23_b,3,891
172,173,136,228,664,328,336,0,1,1,ABMrun_3.1.23_b,3,892
173,165,135,220,680,334,346,0,1,1,ABMrun_3.1.23_b,3,900
174,177,135,221,675,327,348,0,1,1,ABMrun_3.1.23_b,3,896
175,176,141,224,668,312,356,0,1,1,ABMrun_3.1.23_b,3,892
176,169,138,210,706,319,387,0,1,1,ABMrun_3.1.23_b,3,916
177,178,144,230,652,309,343,0,1,1,ABMrun_3.1.23_b,3,882
178,182,139,236,627,310,317,0,1,1,ABMrun_3.1.23_b,3,863
179,186,136,236,640,335,305,0,1,1,ABMrun_3.1.23_b,3,876
180,170,126,228,663,348,315,0,1,1,ABMrun_3.1.23_b,3,891
181,176,131,227,667,347,320,0,1,1,ABMrun_3.1.23_b,3,894
182,158,123,208,713,373,340,0,1,1,ABMrun_3.1.23_b,3,921
183,170,134,216,688,336,352,0,1,1,ABMrun_3.1.23_b,3,904
184,172,136,227,657,327,330,0,1,1,ABMrun_3.1.23_b,3,884
185,178,143,227,662,331,331,0,1,1,ABMrun_3.1.23_b,3,889
186,173,139,223,673,325,348,0,1,1,ABMrun_3.1.23_b,3,896
187,175,139,230,652,320,332,0,1,1,ABMrun_3.1.23_b,3,882
188,173,142,221,670,308,362,0,1,1,ABMrun_3.1.23_b,3,891
189,179,144,228,656,307,349,0,1,1,ABMrun_3.1.23_b,3,884
190,170,137,223,674,322,352,0,1,1,ABMrun_3.1.23_b,3,897
191,176,143,222,672,330,342,0,1,1,ABMrun_3.1.23_b,3,894
192,183,140,232,649,332,317,0,1,1,ABMrun_3.1.23_b,3,881
193,183,140,233,641,315,326,0,1,1,ABMrun_3.1.23_b,3,874
194,171,136,224,671,327,344,0,1,1,ABMrun_3.1.23_b,3,895
195,174,132,223,675,324,351,0,1,1,ABMrun_3.1.23_b,3,898
196,167,142,222,677,331,346,0,1,1,ABMrun_3.1.23_b,3,899
197,171,130,222,674,317,357,0,1,1,ABMrun_3.1.23_b,3,896
198,175,134,226,659,320,339,0,1,1,ABMrun_3.1.23_b,3,885
199,172,133,226,661,325,336,0,1,1,ABMrun_3.1.23_b,3,887
200,169,129,225,665,322,343,0,1,1,ABMrun_3.1.23_b,3,890
201,159,131,206,718,355,363,0,1,1,ABMrun_3.1.23_b,3,924
202,175,136,226,668,339,329,0,1,1,ABMrun_3.1.23_b,3,894
203,174,134,231,648,335,313,0,1,1,ABMrun_3.1.23_b,3,879
204,178,140,222,672,354,318,0,1,1,ABMrun_3.1.23_b,3,894
205,176,136,230,656,342,314,0,1,1,ABMrun_3.1.23_b,3,886
206,174,136,222,670,346,324,0,1,1,ABMrun_3.1.23_b,3,892
207,171,128,220,678,349,329,0,1,1,ABMrun_3.1.23_b,3,898
208,167,129,210,701,351,350,0,1,1,ABMrun_3.1.23_b,3,911
209,171,138,215,685,336,349,0,1,1,ABMrun_3.1.23_b,3,900
210,171,127,219,680,350,330,0,1,1,ABMrun_3.1.23_b,3,899
211,176,135,228,656,326,330,0,1,1,ABMrun_3.1.23_b,3,884
212,175,144,224,663,329,334,0,1,1,ABMrun_3.1.23_b,3,887
213,176,147,219,687,337,350,0,1,1,ABMrun_3.1.23_b,3,906
214,172,143,221,677,326,351,0,1,1,ABMrun_3.1.23_b,3,898
215,167,140,212,701,337,364,0,1,1,ABMrun_3.1.23_b,3,913
216,184,145,225,670,322,348,0,1,1,ABMrun_3.1.23_b,3,895
217,182,139,225,663,318,345,0,1,1,ABMrun_3.1.23_b,3,888
218,171,133,220,679,338,341,0,1,1,ABMrun_3.1.23_b,3,899
219,171,132,222,675,341,334,0,1,1,ABMrun_3.1.23_b,3,897
220,174,133,228,653,320,333,0,1,1,ABMrun_3.1.23_b,3,881
221,173,137,224,665,319,346,0,1,1,ABMrun_3.1.23_b,3,889
222,172,140,218,681,341,340,0,1,1,ABMrun_3.1.23_b,3,899
223,167,124,219,681,347,334,0,1,1,ABMrun_3.1.23_b,3,900
224,172,130,219,682,365,317,0,1,1,ABMrun_3.1.23_b,3,901
225,177,139,224,666,357,309,0,1,1,ABMrun_3.1.23_b,3,890
226,162,140,208,715,367,348,0,1,1,ABMrun_3.1.23_b,3,923
227,187,138,229,647,329,318,0,1,1,ABMrun_3.1.23_b,3,876
228,178,142,227,655,314,341,0,1,1,ABMrun_3.1.23_b,3,882
229,171,130,225,661,314,347,0,1,1,ABMrun_3.1.23_b,3,886
230,176,135,225,661,327,334,0,1,1,ABMrun_3.1.23_b,3,886
231,172,132,216,693,345,348,0,1,1,ABMrun_3.1.23_b,3,909
232,184,133,225,664,342,322,0,1,1,ABMrun_3.1.23_b,3,889
233,177,135,230,649,344,305,0,1,1,ABMrun_3.1.23_b,3,879
234,178,138,226,663,328,335,0,1,1,ABMrun_3.1.23_b,3,889
235,169,130,220,679,320,359,0,1,1,ABMrun_3.1.23_b,3,899
236,167,140,220,674,314,360,0,1,1,ABMrun_3.1.23_b,3,894
237,177,133,226,653,312,341,0,1,1,ABMrun_3.1.23_b,3,879
238,180,139,232,648,319,329,0,1,1,ABMrun_3.1.23_b,3,880
239,169,127,221,677,328,349,0,1,1,ABMrun_3.1.23_b,3,898
240,173,141,219,680,326,354,0,1,1,ABMrun_3.1.23_b,3,899
241,170,131,222,672,322,350,0,1,1,ABMrun_3.1.23_b,3,894
242,165,136,210,703,348,355,0,1,1,ABMrun_3.1.23_b,3,913
243,164,129,216,691,344,347,0,1,1,ABMrun_3.1.23_b,3,907
244,166,137,216,690,351,339,0,1,1,ABMrun_3.1.23_b,3,906
245,178,137,231,648,315,333,0,1,1,ABMrun_3.1.23_b,3,879
246,178,140,225,657,324,333,0,1,1,ABMrun_3.1.23_b,3,882
247,174,138,223,660,329,331,0,1,1,ABMrun_3.1.23_b,3,883
248,168,130,217,685,362,323,0,1,1,ABMrun_3.1.23_b,3,902
249,168,134,217,684,338,346,0,1,1,ABMrun_3.1.23_b,3,901
250,181,134,230,647,325,322,0,1,1,ABMrun_3.1.23_b,3,877
251,158,121,208,710,352,358,0,1,1,ABMrun_3.1.23_b,3,918
252,178,132,219,687,330,357,0,1,1,ABMrun_3.1.23_b,3,906
253,181,139,227,659,326,333,0,1,1,ABMrun_3.1.23_b,3,886
254,172,137,228,658,312,346,0,1,1,ABMrun_3.1.23_b,3,886
255,175,141,215,688,351,337,0,1,1,ABMrun_3.1.23_b,3,903
256,169,129,213,702,357,345,0,1,1,ABMrun_3.1.23_b,3,915
257,170,139,213,695,350,345,0,1,1,ABMrun_3.1.23_b,3,908
258,175,135,222,675,340,335,0,1,1,ABMrun_3.1.23_b,3,897
259,176,132,226,666,330,336,0,1,1,ABMrun_3.1.23_b,3,892
260,179,131,225,658,339,319,0,1,1,ABMrun_3.1.23_b,3,883
261,175,138,231,650,326,324,0,1,1,ABMrun_3.1.23_b,3,881
262,178,134,222,669,327,342,0,1,1,ABMrun_3.1.23_b,3,891
263,173,140,226,661,323,338,0,1,1,ABMrun_3.1.23_b,3,887
264,178,141,234,642,320,322,0,1,1,ABMrun_3.1.23_b,3,876
265,171,136,225,666,316,350,0,1,1,ABMrun_3.1.23_b,3,891
266,183,138,231,646,320,326,0,1,1,ABMrun_3.1.23_b,3,877
267,181,146,232,638,324,314,0,1,1,ABMrun_3.1.23_b,3,870
268,178,143,227,654,327,327,0,1,1,ABMrun_3.1.23_b,3,881
269,176,139,228,658,338,320,0,1,1,ABMrun_3.1.23_b,3,886
270,170,132,224,670,338,332,0,1,1,ABMrun_3.1.23_b,3,894
271,182,138,232,636,313,323,0,1,1,ABMrun_3.1.23_b,3,868
272,178,144,226,672,331,341,0,1,1,ABMrun_3.1.23_b,3,898
273,160,122,216,688,338,350,0,1,1,ABMrun_3.1.23_b,3,904
274,175,136,226,668,342,326,0,1,1,ABMrun_3.1.23_b,3,894
275,179,148,231,654,321,333,0,1,1,ABMrun_3.1.23_b,3,885
276,175,134,216,691,350,341,0,1,1,ABMrun_3.1.23_b,3,907
277,174,136,223,675,328,347,0,1,1,ABMrun_3.1.23_b,3,898
278,172,138,230,655,306,349,0,1,1,ABMrun_3.1.23_b,3,885
279,180,145,227,655,313,342,0,1,1,ABMrun_3.1.23_b,3,882
280,171,132,225,663,324,339,0,1,1,ABMrun_3.1.23_b,3,888
281,169,140,219,685,336,349,0,1,1,ABMrun_3.1.23_b,3,904
282,178,130,229,653,311,342,0,1,1,ABMrun_3.1.23_b,3,882
283,172,135,219,684,327,357,0,1,1,ABMrun_3.1.23_b,3,903
284,172,134,223,670,323,347,0,1,1,ABMrun_3.1.23_b,3,893
285,187,140,227,660,325,335,0,1,1,ABMrun_3.1.23_b,3,887
286,167,133,215,690,335,355,0,1,1,ABMrun_3.1.23_b,3,905
287,173,138,224,665,319,346,0,1,1,ABMrun_3.1.23_b,3,889
288,174,144,222,665,310,355,0,1,1,ABMrun_3.1.23_b,3,887
289,170,138,224,666,316,350,0,1,1,ABMrun_3.1.23_b,3,890
290,179,136,231,634,292,342,0,1,1,ABMrun_3.1.23_b,3,865
291,172,135,221,674,310,364,0,1,1,ABMrun_3.1.23_b,3,895
292,174,143,218,683,319,364,0,1,1,ABMrun_3.1.23_b,3,901
293,182,136,229,652,312,340,0,1,1,ABMrun_3.1.23_b,3,881
294,179,143,223,676,332,344,0,1,1,ABMrun_3.1.23_b,3,899
295,176,144,229,654,327,327,0,1,1,ABMrun_3.1.23_b,3,883
296,164,133,220,676,334,342,0,1,1,ABMrun_3.1.23_b,3,896
297,174,134,227,655,330,325,0,1,1,ABMrun_3.1.23_b,3,882
298,180,141,230,643,316,327,0,1,1,ABMrun_3.1.23_b,3,873
299,178,145,228,672,339,333,0,1,1,ABMrun_3.1.23_b,3,900
300,178,142,220,676,345,331,0,1,1,ABMrun_3.1.23_b,3,896
301,171,138,216,686,349,337,0,1,1,ABMrun_3.1.23_b,3,902
302,176,141,223,674,342,332,0,1,1,ABMrun_3.1.23_b,3,897
303,177,138,226,663,330,333,0,1,1,ABMrun_3.1.23_b,3,889
304,175,146,226,656,316,340,0,1,1,ABMrun_3.1.23_b,3,882
305,167,130,233,648,311,337,0,1,1,ABMrun_3.1.23_b,3,881
306,172,137,226,672,331,341,0,1,1,ABMrun_3.1.23_b,3,898
307,184,149,233,643,305,338,0,1,1,ABMrun_3.1.23_b,3,876
308,182,136,232,654,315,339,0,1,1,ABMrun_3.1.23_b,3,886
309,171,136,221,674,338,336,0,1,1,ABMrun_3.1.23_b,3,895
310,174,138,227,656,346,310,0,1,1,ABMrun_3.1.23_b,3,883
311,173,129,225,665,349,316,0,1,1,ABMrun_3.1.23_b,3,890
312,166,127,216,689,375,314,0,1,1,ABMrun_3.1.23_b,3,905
313,176,133,229,653,344,309,0,1,1,ABMrun_3.1.23_b,3,882
314,169,137,223,672,334,338,0,1,1,ABMrun_3.1.23_b,3,895
315,175,138,223,676,337,339,0,1,1,ABMrun_3.1.23_b,3,899
316,183,148,223,679,323,356,0,1,1,ABMrun_3.1.23_b,3,902
317,180,132,223,671,325,346,0,1,1,ABMrun_3.1.23_b,3,894
318,174,133,227,663,321,342,0,1,1,ABMrun_3.1.23_b,3,890
319,180,149,226,665,318,347,0,1,1,ABMrun_3.1.23_b,3,891
320,172,141,218,675,334,341,0,1,1,ABMrun_3.1.23_b,3,893
321,170,128,220,678,332,346,0,1,1,ABMrun_3.1.23_b,3,898
322,175,138,229,656,321,335,0,1,1,ABMrun_3.1.23_b,3,885
323,183,135,231,641,322,319,0,1,1,ABMrun_3.1.23_b,3,872
324,174,141,220,677,337,340,0,1,1,ABMrun_3.1.23_b,3,897
325,181,146,225,675,344,331,0,1,1,ABMrun_3.1.23_b,3,900
326,151,122,196,739,373,366,0,1,1,ABMrun_3.1.23_b,3,935
327,180,141,228,659,323,336,0,1,1,ABMrun_3.1.23_b,3,887
328,183,148,229,655,323,332,0,1,1,ABMrun_3.1.23_b,3,884
329,179,135,232,644,323,321,0,1,1,ABMrun_3.1.23_b,3,876
330,181,131,227,659,336,323,0,1,1,ABMrun_3.1.23_b,3,886
331,176,135,227,658,341,317,0,1,1,ABMrun_3.1.23_b,3,885
332,168,129,221,673,338,335,0,1,1,ABMrun_3.1.23_b,3,894
333,170,130,217,688,340,348,0,1,1,ABMrun_3.1.23_b,3,905
334,170,131,215,689,343,346,0,1,1,ABMrun_3.1.23_b,3,904
335,177,138,222,678,346,332,0,1,1,ABMrun_3.1.23_b,3,900
336,172,134,222,670,335,335,0,1,1,ABMrun_3.1.23_b,3,892
337,182,146,230,645,302,343,0,1,1,ABMrun_3.1.23_b,3,875
338,180,138,237,627,311,316,0,1,1,ABMrun_3.1.23_b,3,864
339,170,131,224,668,343,325,0,1,1,ABMrun_3.1.23_b,3,892
340,173,130,221,679,335,344,0,1,1,ABMrun_3.1.23_b,3,900
341,180,141,222,673,340,333,0,1,1,ABMrun_3.1.23_b,3,895
342,171,132,228,659,334,325,0,1,1,ABMrun_3.1.23_b,3,887
343,178,138,229,655,321,334,0,1,1,ABMrun_3.1.23_b,3,884
344,172,129,222,664,334,330,0,1,1,ABMrun_3.1.23_b,3,886
345,175,134,229,653,332,321,0,1,1,ABMrun_3.1.23_b,3,882
346,175,149,221,669,329,340,0,1,1,ABMrun_3.1.23_b,3,890
347,170,139,227,663,320,343,0,1,1,ABMrun_3.1.23_b,3,890
348,180,138,226,664,317,347,0,1,1,ABMrun_3.1.23_b,3,890
349,175,137,226,660,317,343,0,1,1,ABMrun_3.1.23_b,3,886
350,169,127,228,660,327,333,0,1,1,ABMrun_3.1.23_b,3,888
1,21,20,26,611,320,291,0,2,1,ABMrun_3.1.23_b,3,637
2,95,87,123,860,423,437,0,2,1,ABMrun_3.1.23_b,3,983
3,129,108,166,797,397,400,0,2,1,ABMrun_3.1.23_b,3,963
4,157,123,204,725,354,371,0,2,1,ABMrun_3.1.23_b,3,929
5,178,142,222,680,349,331,0,2,1,ABMrun_3.1.23_b,3,902
6,185,138,235,632,341,291,0,2,1,ABMrun_3.1.23_b,3,867
7,176,130,230,664,364,300,0,2,1,ABMrun_3.1.23_b,3,894
8,190,139,234,650,335,315,0,2,1,ABMrun_3.1.23_b,3,884
9,180,134,232,648,318,330,0,2,1,ABMrun_3.1.23_b,3,880
10,182,135,235,635,316,319,0,2,1,ABMrun_3.1.23_b,3,870
11,173,128,236,639,317,322,0,2,1,ABMrun_3.1.23_b,3,875
12,180,141,230,648,318,330,0,2,1,ABMrun_3.1.23_b,3,878
13,176,133,227,664,340,324,0,2,1,ABMrun_3.1.23_b,3,891
14,168,140,224,681,335,346,0,2,1,ABMrun_3.1.23_b,3,905
15,177,138,227,670,346,324,0,2,1,ABMrun_3.1.23_b,3,897
16,183,139,231,651,326,325,0,2,1,ABMrun_3.1.23_b,3,882
17,173,140,224,669,333,336,0,2,1,ABMrun_3.1.23_b,3,893
18,171,135,228,670,323,347,0,2,1,ABMrun_3.1.23_b,3,898
19,175,135,221,682,325,357,0,2,1,ABMrun_3.1.23_b,3,903
20,173,135,231,656,310,346,0,2,1,ABMrun_3.1.23_b,3,887
21,168,129,220,690,334,356,0,2,1,ABMrun_3.1.23_b,3,910
22,177,134,234,642,313,329,0,2,1,ABMrun_3.1.23_b,3,876
23,185,131,237,628,311,317,0,2,1,ABMrun_3.1.23_b,3,865
24,184,141,236,644,316,328,0,2,1,ABMrun_3.1.23_b,3,880
25,184,141,233,634,300,334,0,2,1,ABMrun_3.1.23_b,3,867
26,161,133,206,720,346,374,0,2,1,ABMrun_3.1.23_b,3,926
27,173,136,229,654,325,329,0,2,1,ABMrun_3.1.23_b,3,883
28,187,144,236,626,321,305,0,2,1,ABMrun_3.1.23_b,3,862
29,181,136,230,652,323,329,0,2,1,ABMrun_3.1.23_b,3,882
30,179,142,224,677,332,345,0,2,1,ABMrun_3.1.23_b,3,901
31,182,138,231,648,325,323,0,2,1,ABMrun_3.1.23_b,3,879
32,187,138,234,639,331,308,0,2,1,ABMrun_3.1.23_b,3,873
33,178,135,225,668,339,329,0,2,1,ABMrun_3.1.23_b,3,893
34,182,137,226,674,345,329,0,2,1,ABMrun_3.1.23_b,3,900
35,170,131,226,671,333,338,0,2,1,ABMrun_3.1.23_b,3,897
36,183,133,229,663,328,335,0,2,1,ABMrun_3.1.23_b,3,892
37,174,138,227,657,325,332,0,2,1,ABMrun_3.1.23_b,3,884
38,178,137,221,682,324,358,0,2,1,ABMrun_3.1.23_b,3,903
39,173,139,227,665,323,342,0,2,1,ABMrun_3.1.23_b,3,892
40,183,149,231,649,315,334,0,2,1,ABMrun_3.1.23_b,3,880
41,177,135,231,651,312,339,0,2,1,ABMrun_3.1.23_b,3,882
42,173,138,227,664,344,320,0,2,1,ABMrun_3.1.23_b,3,891
43,177,136,226,664,348,316,0,2,1,ABMrun_3.1.23_b,3,890
44,184,133,234,646,318,328,0,2,1,ABMrun_3.1.23_b,3,880
45,181,140,231,649,297,352,0,2,1,ABMrun_3.1.23_b,3,880
46,169,134,221,682,326,356,0,2,1,ABMrun_3.1.23_b,3,903
47,182,136,231,650,316,334,0,2,1,ABMrun_3.1.23_b,3,881
48,169,136,224,664,327,337,0,2,1,ABMrun_3.1.23_b,3,888
49,181,134,234,641,311,330,0,2,1,ABMrun_3.1.23_b,3,875
50,176,136,229,654,323,331,0,2,1,ABMrun_3.1.23_b,3,883
51,163,128,218,698,362,336,0,2,1,ABMrun_3.1.23_b,3,916
52,182,138,229,663,354,309,0,2,1,ABMrun_3.1.23_b,3,892
53,178,134,238,632,321,311,0,2,1,ABMrun_3.1.23_b,3,870
54,166,132,217,685,343,342,0,2,1,ABMrun_3.1.23_b,3,902
55,178,134,229,666,333,333,0,2,1,ABMrun_3.1.23_b,3,895
56,188,135,235,628,309,319,0,2,1,ABMrun_3.1.23_b,3,863
57,184,149,234,647,326,321,0,2,1,ABMrun_3.1.23_b,3,881
58,172,135,225,663,329,334,0,2,1,ABMrun_3.1.23_b,3,888
59,180,138,227,656,338,318,0,2,1,ABMrun_3.1.23_b,3,883
60,184,136,231,651,331,320,0,2,1,ABMrun_3.1.23_b,3,882
61,184,145,237,621,310,311,0,2,1,ABMrun_3.1.23_b,3,858
62,177,136,234,640,321,319,0,2,1,ABMrun_3.1.23_b,3,874
63,176,142,229,669,334,335,0,2,1,ABMrun_3.1.23_b,3,898
64,172,137,226,665,337,328,0,2,1,ABMrun_3.1.23_b,3,891
65,185,144,228,673,340,333,0,2,1,ABMrun_3.1.23_b,3,901
66,189,142,244,601,294,307,0,2,1,ABMrun_3.1.23_b,3,845
67,184,128,240,632,314,318,0,2,1,ABMrun_3.1.23_b,3,872
68,175,139,227,664,334,330,0,2,1,ABMrun_3.1.23_b,3,891
69,177,132,229,659,332,327,0,2,1,ABMrun_3.1.23_b,3,888
70,177,132,230,648,338,310,0,2,1,ABMrun_3.1.23_b,3,878
71,178,127,226,676,350,326,0,2,1,ABMrun_3.1.23_b,3,902
72,185,131,232,656,348,308,0,2,1,ABMrun_3.1.23_b,3,888
73,188,138,235,634,322,312,0,2,1,ABMrun_3.1.23_b,3,869
74,173,133,230,654,324,330,0,2,1,ABMrun_3.1.23_b,3,884
75,181,143,224,673,327,346,0,2,1,ABMrun_3.1.23_b,3,897
76,160,129,206,711,360,351,0,2,1,ABMrun_3.1.23_b,3,917
77,170,135,226,670,335,335,0,2,1,ABMrun_3.1.23_b,3,896
78,179,138,231,648,317,331,0,2,1,ABMrun_3.1.23_b,3,879
79,185,143,234,644,290,354,0,2,1,ABMrun_3.1.23_b,3,878
80,190,141,236,636,292,344,0,2,1,ABMrun_3.1.23_b,3,872
81,179,142,227,668,312,356,0,2,1,ABMrun_3.1.23_b,3,895
82,186,146,237,640,312,328,0,2,1,ABMrun_3.1.23_b,3,877
83,184,136,233,643,322,321,0,2,1,ABMrun_3.1.23_b,3,876
84,182,144,231,654,329,325,0,2,1,ABMrun_3.1.23_b,3,885
85,168,135,223,674,334,340,0,2,1,ABMrun_3.1.23_b,3,897
86,170,137,224,670,330,340,0,2,1,ABMrun_3.1.23_b,3,894
87,178,145,230,657,315,342,0,2,1,ABMrun_3.1.23_b,3,887
88,185,140,235,636,299,337,0,2,1,ABMrun_3.1.23_b,3,871
89,181,139,236,637,300,337,0,2,1,ABMrun_3.1.23_b,3,873
90,180,140,233,642,314,328,0,2,1,ABMrun_3.1.23_b,3,875
91,171,141,231,659,312,347,0,2,1,ABMrun_3.1.23_b,3,890
92,179,142,228,660,304,356,0,2,1,ABMrun_3.1.23_b,3,888
93,172,142,223,681,312,369,0,2,1,ABMrun_3.1.23_b,3,904
94,177,138,227,666,306,360,0,2,1,ABMrun_3.1.23_b,3,893
95,175,142,229,659,296,363,0,2,1,ABMrun_3.1.23_b,3,888
96,175,137,228,662,306,356,0,2,1,ABMrun_3.1.23_b,3,890
97,189,141,234,633,319,314,0,2,1,ABMrun_3.1.23_b,3,867
98,183,136,234,636,322,314,0,2,1,ABMrun_3.1.23_b,3,870
99,183,142,230,663,348,315,0,2,1,ABMrun_3.1.23_b,3,893
100,182,143,226,628,299,329,0,2,1,ABMrun_3.1.23_b,3,854
101,135,104,179,708,349,359,0,2,1,ABMrun_3.1.23_b,3,887
102,145,119,189,641,323,318,0,2,1,ABMrun_3.1.23_b,3,830
103,156,121,200,586,296,290,0,2,1,ABMrun_3.1.23_b,3,786
104,137,110,181,592,300,292,0,2,1,ABMrun_3.1.23_b,3,773
105,136,109,175,574,289,285,0,2,1,ABMrun_3.1.23_b,3,749
106,122,97,163,561,291,270,0,2,1,ABMrun_3.1.23_b,3,724
107,130,98,166,526,264,262,0,2,1,ABMrun_3.1.23_b,3,692
108,136,105,170,479,243,236,0,2,1,ABMrun_3.1.23_b,3,649
109,124,94,151,487,261,226,0,2,1,ABMrun_3.1.23_b,3,638
110,65,58,83,451,236,215,0,2,1,ABMrun_3.1.23_b,3,534
111,70,59,89,365,192,173,0,2,1,ABMrun_3.1.23_b,3,454
112,71,60,89,325,166,159,0,2,1,ABMrun_3.1.23_b,3,414
113,65,53,87,285,141,144,0,2,1,ABMrun_3.1.23_b,3,372
114,63,51,84,283,146,137,0,2,1,ABMrun_3.1.23_b,3,367
115,66,52,84,269,142,127,0,2,1,ABMrun_3.1.23_b,3,353
116,60,46,80,252,122,130,0,2,1,ABMrun_3.1.23_b,3,332
117,60,49,78,239,132,107,0,2,1,ABMrun_3.1.23_b,3,317
118,58,47,79,247,129,118,0,2,1,ABMrun_3.1.23_b,3,326
119,61,44,78,240,135,105,0,2,1,ABMrun_3.1.23_b,3,318
120,58,45,77,233,139,94,0,2,1,ABMrun_3.1.23_b,3,310
121,61,47,76,238,138,100,0,2,1,ABMrun_3.1.23_b,3,314
122,64,47,79,240,125,115,0,2,1,ABMrun_3.1.23_b,3,319
123,59,50,78,242,125,117,0,2,1,ABMrun_3.1.23_b,3,320
124,57,47,75,232,112,120,0,2,1,ABMrun_3.1.23_b,3,307
125,59,43,76,222,117,105,0,2,1,ABMrun_3.1.23_b,3,298
126,59,43,75,230,122,108,0,2,1,ABMrun_3.1.23_b,3,305
127,59,46,76,214,108,106,0,2,1,ABMrun_3.1.23_b,3,290
128,60,47,74,210,102,108,0,2,1,ABMrun_3.1.23_b,3,284
129,61,51,75,214,107,107,0,2,1,ABMrun_3.1.23_b,3,289
130,63,45,77,223,114,109,0,2,1,ABMrun_3.1.23_b,3,300
131,61,44,74,220,109,111,0,2,1,ABMrun_3.1.23_b,3,294
132,59,46,75,213,106,107,0,2,1,ABMrun_3.1.23_b,3,288
133,53,39,73,207,100,107,0,2,1,ABMrun_3.1.23_b,3,280
134,56,46,71,206,93,113,0,2,1,ABMrun_3.1.23_b,3,277
135,51,41,67,194,91,103,0,2,1,ABMrun_3.1.23_b,3,261
136,52,41,71,204,99,105,0,2,1,ABMrun_3.1.23_b,3,275
137,58,40,72,211,104,107,0,2,1,ABMrun_3.1.23_b,3,283
138,59,45,72,208,98,110,0,2,1,ABMrun_3.1.23_b,3,280
139,53,40,72,206,102,104,0,2,1,ABMrun_3.1.23_b,3,278
140,57,49,74,211,108,103,0,2,1,ABMrun_3.1.23_b,3,285
141,56,45,72,202,101,101,0,2,1,ABMrun_3.1.23_b,3,274
142,57,45,72,207,93,114,0,2,1,ABMrun_3.1.23_b,3,279
143,54,45,71,203,89,114,0,2,1,ABMrun_3.1.23_b,3,274
144,51,38,69,196,94,102,0,2,1,ABMrun_3.1.23_b,3,265
145,56,46,70,201,93,108,0,2,1,ABMrun_3.1.23_b,3,271
146,58,43,70,202,107,95,0,2,1,ABMrun_3.1.23_b,3,272
147,52,36,72,206,105,101,0,2,1,ABMrun_3.1.23_b,3,278
148,58,40,69,197,100,97,0,2,1,ABMrun_3.1.23_b,3,266
149,54,44,68,201,107,94,0,2,1,ABMrun_3.1.23_b,3,269
150,55,42,68,191,98,93,0,2,1,ABMrun_3.1.23_b,3,259
151,109,77,158,229,112,117,17,2,1,ABMrun_3.1.23_b,3,387
152,129,89,180,301,141,160,10,2,1,ABMrun_3.1.23_b,3,481
153,150,105,197,387,182,205,5,2,1,ABMrun_3.1.23_b,3,584
154,156,118,201,466,218,248,2,2,1,ABMrun_3.1.23_b,3,667
155,152,117,203,529,258,271,0,2,1,ABMrun_3.1.23_b,3,732
156,165,123,206,559,263,296,0,2,1,ABMrun_3.1.23_b,3,765
157,165,125,214,583,263,320,0,2,1,ABMrun_3.1.23_b,3,797
158,172,127,223,580,273,307,0,2,1,ABMrun_3.1.23_b,3,803
159,182,144,226,615,290,325,0,2,1,ABMrun_3.1.23_b,3,841
160,187,141,237,615,284,331,0,2,1,ABMrun_3.1.23_b,3,852
161,182,133,236,628,294,334,0,2,1,ABMrun_3.1.23_b,3,864
162,171,134,226,669,311,358,0,2,1,ABMrun_3.1.23_b,3,895
163,163,133,211,701,330,371,0,2,1,ABMrun_3.1.23_b,3,912
164,175,139,224,673,328,345,0,2,1,ABMrun_3.1.23_b,3,897
165,165,131,212,697,329,368,6,2,1,ABMrun_3.1.23_b,3,909
166,180,141,226,662,321,341,5,2,1,ABMrun_3.1.23_b,3,888
167,180,127,222,675,337,338,4,2,1,ABMrun_3.1.23_b,3,897
168,173,140,222,674,333,341,0,2,1,ABMrun_3.1.23_b,3,896
169,175,131,227,665,341,324,0,2,1,ABMrun_3.1.23_b,3,892
170,179,140,227,660,326,334,0,2,1,ABMrun_3.1.23_b,3,887
171,177,139,228,660,320,340,0,2,1,ABMrun_3.1.23_b,3,888
172,184,140,233,634,320,314,0,2,1,ABMrun_3.1.23_b,3,867
173,181,140,226,669,335,334,0,2,1,ABMrun_3.1.23_b,3,895
174,178,133,228,650,331,319,0,2,1,ABMrun_3.1.23_b,3,878
175,183,130,230,651,336,315,0,2,1,ABMrun_3.1.23_b,3,881
176,165,134,207,711,356,355,0,2,1,ABMrun_3.1.23_b,3,918
177,172,135,219,676,338,338,0,2,1,ABMrun_3.1.23_b,3,895
178,174,133,225,662,328,334,0,2,1,ABMrun_3.1.23_b,3,887
179,175,134,227,659,329,330,0,2,1,ABMrun_3.1.23_b,3,886
180,180,140,230,653,330,323,0,2,1,ABMrun_3.1.23_b,3,883
181,161,133,210,707,354,353,10,2,1,ABMrun_3.1.23_b,3,917
182,176,142,225,662,322,340,4,2,1,ABMrun_3.1.23_b,3,887
183,168,134,223,679,323,356,3,2,1,ABMrun_3.1.23_b,3,902
184,182,137,228,659,326,333,2,2,1,ABMrun_3.1.23_b,3,887
185,179,137,224,677,341,336,1,2,1,ABMrun_3.1.23_b,3,901
186,168,143,217,690,340,350,1,2,1,ABMrun_3.1.23_b,3,907
187,176,131,226,658,332,326,0,2,1,ABMrun_3.1.23_b,3,884
188,179,142,228,652,315,337,0,2,1,ABMrun_3.1.23_b,3,880
189,170,132,222,675,324,351,0,2,1,ABMrun_3.1.23_b,3,897
190,176,135,224,668,325,343,0,2,1,ABMrun_3.1.23_b,3,892
191,162,125,214,700,343,357,0,2,1,ABMrun_3.1.23_b,3,914
192,171,133,223,672,329,343,0,2,1,ABMrun_3.1.23_b,3,895
193,172,138,224,660,330,330,0,2,1,ABMrun_3.1.23_b,3,884
194,179,139,227,655,327,328,0,2,1,ABMrun_3.1.23_b,3,882
195,174,139,224,674,354,320,10,2,1,ABMrun_3.1.23_b,3,898
196,180,143,231,656,330,326,4,2,1,ABMrun_3.1.23_b,3,887
197,177,133,226,670,343,327,4,2,1,ABMrun_3.1.23_b,3,896
198,174,132,227,668,330,338,2,2,1,ABMrun_3.1.23_b,3,895
199,178,141,222,672,335,337,1,2,1,ABMrun_3.1.23_b,3,894
200,176,136,221,676,324,352,0,2,1,ABMrun_3.1.23_b,3,897
201,162,127,206,722,354,368,0,2,1,ABMrun_3.1.23_b,3,928
202,177,138,232,648,317,331,0,2,1,ABMrun_3.1.23_b,3,880
203,178,130,228,647,310,337,0,2,1,ABMrun_3.1.23_b,3,875
204,182,147,229,654,312,342,0,2,1,ABMrun_3.1.23_b,3,883
205,173,137,220,681,322,359,0,2,1,ABMrun_3.1.23_b,3,901
206,175,138,229,652,317,335,0,2,1,ABMrun_3.1.23_b,3,881
207,181,144,237,629,309,320,0,2,1,ABMrun_3.1.23_b,3,866
208,178,137,225,671,321,350,0,2,1,ABMrun_3.1.23_b,3,896
209,173,131,222,675,322,353,0,2,1,ABMrun_3.1.23_b,3,897
210,171,133,219,679,343,336,0,2,1,ABMrun_3.1.23_b,3,898
211,168,125,223,673,354,319,0,2,1,ABMrun_3.1.23_b,3,896
212,177,129,227,663,342,321,0,2,1,ABMrun_3.1.23_b,3,890
213,175,133,226,670,348,322,0,2,1,ABMrun_3.1.23_b,3,896
214,171,132,225,657,338,319,0,2,1,ABMrun_3.1.23_b,3,882
215,181,142,231,649,327,322,0,2,1,ABMrun_3.1.23_b,3,880
216,170,134,225,666,337,329,0,2,1,ABMrun_3.1.23_b,3,891
217,180,146,220,681,352,329,0,2,1,ABMrun_3.1.23_b,3,901
218,167,135,214,690,346,344,0,2,1,ABMrun_3.1.23_b,3,904
219,174,135,219,677,336,341,0,2,1,ABMrun_3.1.23_b,3,896
220,180,136,227,658,329,329,0,2,1,ABMrun_3.1.23_b,3,885
221,179,137,228,658,322,336,0,2,1,ABMrun_3.1.23_b,3,886
222,176,138,227,661,336,325,0,2,1,ABMrun_3.1.23_b,3,888
223,172,131,229,654,345,309,0,2,1,ABMrun_3.1.23_b,3,883
224,175,137,225,658,328,330,0,2,1,ABMrun_3.1.23_b,3,883
225,181,137,228,658,333,325,0,2,1,ABMrun_3.1.23_b,3,886
226,160,128,212,708,364,344,0,2,1,ABMrun_3.1.23_b,3,920
227,183,140,232,639,332,307,0,2,1,ABMrun_3.1.23_b,3,871
228,177,131,231,655,332,323,0,2,1,ABMrun_3.1.23_b,3,886
229,173,138,228,664,328,336,0,2,1,ABMrun_3.1.23_b,3,892
230,176,139,229,656,330,326,0,2,1,ABMrun_3.1.23_b,3,885
231,183,142,231,643,314,329,0,2,1,ABMrun_3.1.23_b,3,874
232,168,132,222,677,323,354,0,2,1,ABMrun_3.1.23_b,3,899
233,175,141,229,665,314,351,0,2,1,ABMrun_3.1.23_b,3,894
234,171,132,228,662,309,353,0,2,1,ABMrun_3.1.23_b,3,890
235,170,136,226,671,329,342,0,2,1,ABMrun_3.1.23_b,3,897
236,174,136,228,666,334,332,0,2,1,ABMrun_3.1.23_b,3,894
237,173,127,227,666,339,327,0,2,1,ABMrun_3.1.23_b,3,893
238,177,131,224,670,332,338,0,2,1,ABMrun_3.1.23_b,3,894
239,171,142,220,680,328,352,0,2,1,ABMrun_3.1.23_b,3,900
240,180,129,230,656,324,332,0,2,1,ABMrun_3.1.23_b,3,886
241,184,142,231,648,311,337,0,2,1,ABMrun_3.1.23_b,3,879
242,186,142,239,630,318,312,0,2,1,ABMrun_3.1.23_b,3,869
243,169,133,225,669,334,335,0,2,1,ABMrun_3.1.23_b,3,894
244,183,130,229,658,336,322,0,2,1,ABMrun_3.1.23_b,3,887
245,173,134,229,655,326,329,0,2,1,ABMrun_3.1.23_b,3,884
246,174,136,223,676,333,343,0,2,1,ABMrun_3.1.23_b,3,899
247,174,134,228,665,329,336,0,2,1,ABMrun_3.1.23_b,3,893
248,175,139,224,672,322,350,0,2,1,ABMrun_3.1.23_b,3,896
249,178,146,221,675,319,356,0,2,1,ABMrun_3.1.23_b,3,896
250,175,127,231,644,315,329,0,2,1,ABMrun_3.1.23_b,3,875
251,169,135,219,685,339,346,0,2,1,ABMrun_3.1.23_b,3,904
252,168,126,226,671,348,323,0,2,1,ABMrun_3.1.23_b,3,897
253,171,135,221,683,344,339,0,2,1,ABMrun_3.1.23_b,3,904
254,172,134,219,689,337,352,0,2,1,ABMrun_3.1.23_b,3,908
255,179,138,228,653,319,334,0,2,1,ABMrun_3.1.23_b,3,881
256,177,137,232,645,303,342,0,2,1,ABMrun_3.1.23_b,3,877
257,174,137,227,651,304,347,0,2,1,ABMrun_3.1.23_b,3,878
258,171,137,224,669,307,362,0,2,1,ABMrun_3.1.23_b,3,893
259,172,132,227,663,312,351,0,2,1,ABMrun_3.1.23_b,3,890
260,176,149,225,669,310,359,0,2,1,ABMrun_3.1.23_b,3,894
261,173,128,221,679,335,344,0,2,1,ABMrun_3.1.23_b,3,900
262,179,140,230,656,327,329,0,2,1,ABMrun_3.1.23_b,3,886
263,173,129,231,655,334,321,0,2,1,ABMrun_3.1.23_b,3,886
264,177,136,226,659,334,325,0,2,1,ABMrun_3.1.23_b,3,885
265,169,130,223,674,327,347,0,2,1,ABMrun_3.1.23_b,3,897
266,181,143,229,649,309,340,0,2,1,ABMrun_3.1.23_b,3,878
267,179,136,230,653,306,347,0,2,1,ABMrun_3.1.23_b,3,883
268,180,126,230,653,338,315,0,2,1,ABMrun_3.1.23_b,3,883
269,173,131,224,674,353,321,0,2,1,ABMrun_3.1.23_b,3,898
270,177,135,225,658,352,306,0,2,1,ABMrun_3.1.23_b,3,883
271,176,123,227,661,360,301,0,2,1,ABMrun_3.1.23_b,3,888
272,176,132,232,651,353,298,0,2,1,ABMrun_3.1.23_b,3,883
273,175,137,225,670,341,329,0,2,1,ABMrun_3.1.23_b,3,895
274,174,125,223,667,336,331,0,2,1,ABMrun_3.1.23_b,3,890
275,176,148,228,657,332,325,0,2,1,ABMrun_3.1.23_b,3,885
276,160,135,211,713,348,365,0,2,1,ABMrun_3.1.23_b,3,924
277,182,138,231,647,324,323,0,2,1,ABMrun_3.1.23_b,3,878
278,175,122,233,637,324,313,0,2,1,ABMrun_3.1.23_b,3,870
279,175,137,229,652,309,343,0,2,1,ABMrun_3.1.23_b,3,881
280,173,136,221,676,312,364,0,2,1,ABMrun_3.1.23_b,3,897
281,168,137,215,700,326,374,0,2,1,ABMrun_3.1.23_b,3,915
282,173,137,222,670,315,355,0,2,1,ABMrun_3.1.23_b,3,892
283,180,135,227,659,311,348,0,2,1,ABMrun_3.1.23_b,3,886
284,178,148,224,667,305,362,0,2,1,ABMrun_3.1.23_b,3,891
285,181,139,231,651,302,349,0,2,1,ABMrun_3.1.23_b,3,882
286,171,131,224,669,336,333,0,2,1,ABMrun_3.1.23_b,3,893
287,183,129,227,656,339,317,0,2,1,ABMrun_3.1.23_b,3,883
288,174,142,220,682,354,328,0,2,1,ABMrun_3.1.23_b,3,902
289,176,139,228,662,348,314,0,2,1,ABMrun_3.1.23_b,3,890
290,179,134,230,652,352,300,0,2,1,ABMrun_3.1.23_b,3,882
291,176,142,225,663,345,318,0,2,1,ABMrun_3.1.23_b,3,888
292,174,141,224,667,335,332,0,2,1,ABMrun_3.1.23_b,3,891
293,168,130,214,692,337,355,0,2,1,ABMrun_3.1.23_b,3,906
294,172,126,220,680,338,342,0,2,1,ABMrun_3.1.23_b,3,900
295,176,139,226,666,316,350,0,2,1,ABMrun_3.1.23_b,3,892
296,181,133,224,670,309,361,0,2,1,ABMrun_3.1.23_b,3,894
297,173,145,229,667,324,343,0,2,1,ABMrun_3.1.23_b,3,896
298,177,141,226,666,335,331,0,2,1,ABMrun_3.1.23_b,3,892
299,168,133,222,677,355,322,0,2,1,ABMrun_3.1.23_b,3,899
300,179,140,226,664,355,309,0,2,1,ABMrun_3.1.23_b,3,890
301,159,129,208,716,380,336,0,2,1,ABMrun_3.1.23_b,3,924
302,176,132,224,664,340,324,0,2,1,ABMrun_3.1.23_b,3,888
303,180,133,224,670,338,332,0,2,1,ABMrun_3.1.23_b,3,894
304,179,142,231,640,309,331,0,2,1,ABMrun_3.1.23_b,3,871
305,169,134,225,663,308,355,0,2,1,ABMrun_3.1.23_b,3,888
306,167,126,218,690,332,358,0,2,1,ABMrun_3.1.23_b,3,908
307,176,141,223,670,319,351,0,2,1,ABMrun_3.1.23_b,3,893
308,178,144,221,671,318,353,0,2,1,ABMrun_3.1.23_b,3,892
309,175,136,222,672,329,343,0,2,1,ABMrun_3.1.23_b,3,894
310,173,137,223,674,329,345,0,2,1,ABMrun_3.1.23_b,3,897
311,171,133,228,666,337,329,0,2,1,ABMrun_3.1.23_b,3,894
312,173,131,223,668,351,317,0,2,1,ABMrun_3.1.23_b,3,891
313,180,142,230,656,332,324,0,2,1,ABMrun_3.1.23_b,3,886
314,169,127,222,667,343,324,0,2,1,ABMrun_3.1.23_b,3,889
315,182,136,232,647,319,328,0,2,1,ABMrun_3.1.23_b,3,879
316,171,138,223,673,343,330,0,2,1,ABMrun_3.1.23_b,3,896
317,177,135,227,655,322,333,0,2,1,ABMrun_3.1.23_b,3,882
318,170,138,228,664,344,320,0,2,1,ABMrun_3.1.23_b,3,892
319,175,131,225,662,352,310,0,2,1,ABMrun_3.1.23_b,3,887
320,180,139,221,682,371,311,0,2,1,ABMrun_3.1.23_b,3,903
321,185,136,230,655,364,291,0,2,1,ABMrun_3.1.23_b,3,885
322,176,139,229,648,353,295,0,2,1,ABMrun_3.1.23_b,3,877
323,181,136,230,651,328,323,0,2,1,ABMrun_3.1.23_b,3,881
324,173,136,224,663,336,327,0,2,1,ABMrun_3.1.23_b,3,887
325,176,136,220,684,352,332,0,2,1,ABMrun_3.1.23_b,3,904
326,151,117,200,739,376,363,0,2,1,ABMrun_3.1.23_b,3,939
327,181,133,223,669,328,341,0,2,1,ABMrun_3.1.23_b,3,892
328,173,128,227,657,327,330,0,2,1,ABMrun_3.1.23_b,3,884
329,172,132,228,650,317,333,0,2,1,ABMrun_3.1.23_b,3,878
330,166,134,218,684,325,359,0,2,1,ABMrun_3.1.23_b,3,902
331,184,141,229,656,300,356,0,2,1,ABMrun_3.1.23_b,3,885
332,178,142,225,666,310,356,0,2,1,ABMrun_3.1.23_b,3,891
333,184,135,234,636,311,325,0,2,1,ABMrun_3.1.23_b,3,870
334,175,138,227,656,319,337,0,2,1,ABMrun_3.1.23_b,3,883
335,179,135,224,676,329,347,0,2,1,ABMrun_3.1.23_b,3,900
336,179,138,230,652,320,332,0,2,1,ABMrun_3.1.23_b,3,882
337,174,137,226,667,341,326,0,2,1,ABMrun_3.1.23_b,3,893
338,178,125,233,641,313,328,0,2,1,ABMrun_3.1.23_b,3,874
339,179,137,228,664,322,342,0,2,1,ABMrun_3.1.23_b,3,892
340,175,133,224,671,329,342,0,2,1,ABMrun_3.1.23_b,3,895
341,178,141,225,666,324,342,0,2,1,ABMrun_3.1.23_b,3,891
342,178,141,228,655,325,330,0,2,1,ABMrun_3.1.23_b,3,883
343,180,138,229,659,322,337,0,2,1,ABMrun_3.1.23_b,3,888
344,182,135,235,636,312,324,0,2,1,ABMrun_3.1.23_b,3,871
345,171,133,229,655,315,340,0,2,1,ABMrun_3.1.23_b,3,884
346,183,141,226,671,319,352,0,2,1,ABMrun_3.1.23_b,3,897
347,175,144,225,668,316,352,0,2,1,ABMrun_3.1.23_b,3,893
348,179,137,225,665,331,334,0,2,1,ABMrun_3.1.23_b,3,890
349,179,144,223,677,347,330,0,2,1,ABMrun_3.1.23_b,3,900
350,171,124,222,675,368,307,0,2,1,ABMrun_3.1.23_b,3,897
1,10,10,15,619,293,326,0,3,1,ABMrun_3.1.23_b,3,634
2,83,77,110,874,430,444,0,3,1,ABMrun_3.1.23_b,3,984
3,140,121,182,777,392,385,0,3,1,ABMrun_3.1.23_b,3,959
4,157,128,209,709,369,340,0,3,1,ABMrun_3.1.23_b,3,918
5,179,136,229,664,338,326,0,3,1,ABMrun_3.1.23_b,3,893
6,183,140,232,650,333,317,0,3,1,ABMrun_3.1.23_b,3,882
7,182,137,235,630,325,305,0,3,1,ABMrun_3.1.23_b,3,865
8,176,125,228,658,337,321,0,3,1,ABMrun_3.1.23_b,3,886
9,180,129,235,653,321,332,0,3,1,ABMrun_3.1.23_b,3,888
10,183,145,233,651,310,341,0,3,1,ABMrun_3.1.23_b,3,884
11,180,140,234,648,306,342,0,3,1,ABMrun_3.1.23_b,3,882
12,178,138,231,648,307,341,0,3,1,ABMrun_3.1.23_b,3,879
13,180,133,232,640,311,329,0,3,1,ABMrun_3.1.23_b,3,872
14,184,140,235,641,326,315,0,3,1,ABMrun_3.1.23_b,3,876
15,176,139,227,667,338,329,0,3,1,ABMrun_3.1.23_b,3,894
16,180,141,229,651,336,315,0,3,1,ABMrun_3.1.23_b,3,880
17,186,143,235,636,341,295,0,3,1,ABMrun_3.1.23_b,3,871
18,181,134,232,649,339,310,0,3,1,ABMrun_3.1.23_b,3,881
19,174,130,231,653,344,309,0,3,1,ABMrun_3.1.23_b,3,884
20,182,134,231,659,344,315,0,3,1,ABMrun_3.1.23_b,3,890
21,183,142,235,635,321,314,0,3,1,ABMrun_3.1.23_b,3,870
22,178,139,236,631,298,333,0,3,1,ABMrun_3.1.23_b,3,867
23,185,149,230,655,309,346,0,3,1,ABMrun_3.1.23_b,3,885
24,181,149,231,656,298,358,0,3,1,ABMrun_3.1.23_b,3,887
25,183,137,233,642,301,341,0,3,1,ABMrun_3.1.23_b,3,875
26,160,130,208,714,340,374,0,3,1,ABMrun_3.1.23_b,3,922
27,180,138,229,664,312,352,0,3,1,ABMrun_3.1.23_b,3,893
28,175,140,228,661,315,346,0,3,1,ABMrun_3.1.23_b,3,889
29,183,137,231,653,317,336,0,3,1,ABMrun_3.1.23_b,3,884
30,183,139,231,647,332,315,0,3,1,ABMrun_3.1.23_b,3,878
31,182,143,239,617,298,319,0,3,1,ABMrun_3.1.23_b,3,856
32,179,136,230,651,315,336,0,3,1,ABMrun_3.1.23_b,3,881
33,186,146,238,628,295,333,0,3,1,ABMrun_3.1.23_b,3,866
34,169,133,225,662,319,343,0,3,1,ABMrun_3.1.23_b,3,887
35,172,141,227,666,318,348,0,3,1,ABMrun_3.1.23_b,3,893
36,184,139,239,638,312,326,0,3,1,ABMrun_3.1.23_b,3,877
37,185,137,238,623,304,319,0,3,1,ABMrun_3.1.23_b,3,861
38,181,147,225,669,312,357,0,3,1,ABMrun_3.1.23_b,3,894
39,177,138,229,665,317,348,0,3,1,ABMrun_3.1.23_b,3,894
40,188,137,234,641,286,355,0,3,1,ABMrun_3.1.23_b,3,875
41,168,137,223,670,318,352,0,3,1,ABMrun_3.1.23_b,3,893
42,177,134,228,662,311,351,0,3,1,ABMrun_3.1.23_b,3,890
43,173,139,224,679,323,356,0,3,1,ABMrun_3.1.23_b,3,903
44,178,136,229,659,302,357,0,3,1,ABMrun_3.1.23_b,3,888
45,181,145,227,649,301,348,0,3,1,ABMrun_3.1.23_b,3,876
46,181,138,227,658,311,347,0,3,1,ABMrun_3.1.23_b,3,885
47,178,141,229,660,319,341,0,3,1,ABMrun_3.1.23_b,3,889
48,183,143,233,645,309,336,0,3,1,ABMrun_3.1.23_b,3,878
49,188,151,234,639,275,364,0,3,1,ABMrun_3.1.23_b,3,873
50,178,133,229,650,283,367,0,3,1,ABMrun_3.1.23_b,3,879
51,163,137,213,702,327,375,0,3,1,ABMrun_3.1.23_b,3,915
52,169,132,219,683,342,341,0,3,1,ABMrun_3.1.23_b,3,902
53,181,131,231,655,332,323,0,3,1,ABMrun_3.1.23_b,3,886
54,182,128,236,636,325,311,0,3,1,ABMrun_3.1.23_b,3,872
55,179,142,225,674,348,326,0,3,1,ABMrun_3.1.23_b,3,899
56,187,139,237,625,323,302,0,3,1,ABMrun_3.1.23_b,3,862
57,174,134,225,663,351,312,0,3,1,ABMrun_3.1.23_b,3,888
58,174,134,221,687,368,319,0,3,1,ABMrun_3.1.23_b,3,908
59,178,135,226,672,368,304,0,3,1,ABMrun_3.1.23_b,3,898
60,173,135,225,666,351,315,0,3,1,ABMrun_3.1.23_b,3,891
61,175,141,228,658,346,312,0,3,1,ABMrun_3.1.23_b,3,886
62,175,135,229,655,337,318,0,3,1,ABMrun_3.1.23_b,3,884
63,171,138,214,703,350,353,0,3,1,ABMrun_3.1.23_b,3,917
64,165,134,213,704,347,357,0,3,1,ABMrun_3.1.23_b,3,917
65,174,140,227,661,323,338,0,3,1,ABMrun_3.1.23_b,3,888
66,176,140,230,658,316,342,0,3,1,ABMrun_3.1.23_b,3,888
67,183,145,234,645,316,329,0,3,1,ABMrun_3.1.23_b,3,879
68,179,142,234,647,308,339,0,3,1,ABMrun_3.1.23_b,3,881
69,175,140,225,671,329,342,0,3,1,ABMrun_3.1.23_b,3,896
70,172,132,220,695,347,348,0,3,1,ABMrun_3.1.23_b,3,915
71,181,142,228,663,341,322,0,3,1,ABMrun_3.1.23_b,3,891
72,176,136,229,656,327,329,0,3,1,ABMrun_3.1.23_b,3,885
73,180,132,231,653,326,327,0,3,1,ABMrun_3.1.23_b,3,884
74,179,141,229,655,318,337,0,3,1,ABMrun_3.1.23_b,3,884
75,177,134,228,654,311,343,0,3,1,ABMrun_3.1.23_b,3,882
76,159,132,209,716,353,363,0,3,1,ABMrun_3.1.23_b,3,925
77,180,138,226,670,342,328,0,3,1,ABMrun_3.1.23_b,3,896
78,182,143,233,643,331,312,0,3,1,ABMrun_3.1.23_b,3,876
79,173,141,225,664,345,319,0,3,1,ABMrun_3.1.23_b,3,889
80,179,130,229,659,349,310,0,3,1,ABMrun_3.1.23_b,3,888
81,184,139,231,649,326,323,0,3,1,ABMrun_3.1.23_b,3,880
82,183,142,229,668,328,340,0,3,1,ABMrun_3.1.23_b,3,897
83,175,131,228,654,324,330,0,3,1,ABMrun_3.1.23_b,3,882
84,179,138,233,640,313,327,0,3,1,ABMrun_3.1.23_b,3,873
85,174,138,231,653,320,333,0,3,1,ABMrun_3.1.23_b,3,884
86,183,141,231,661,322,339,0,3,1,ABMrun_3.1.23_b,3,892
87,183,139,234,645,303,342,0,3,1,ABMrun_3.1.23_b,3,879
88,176,137,230,652,304,348,0,3,1,ABMrun_3.1.23_b,3,882
89,176,132,226,675,323,352,0,3,1,ABMrun_3.1.23_b,3,901
90,173,138,231,652,330,322,0,3,1,ABMrun_3.1.23_b,3,883
91,178,142,231,643,335,308,0,3,1,ABMrun_3.1.23_b,3,874
92,177,137,233,640,335,305,0,3,1,ABMrun_3.1.23_b,3,873
93,176,136,226,671,344,327,0,3,1,ABMrun_3.1.23_b,3,897
94,175,138,226,664,333,331,0,3,1,ABMrun_3.1.23_b,3,890
95,184,135,237,641,315,326,0,3,1,ABMrun_3.1.23_b,3,878
96,192,135,241,624,315,309,0,3,1,ABMrun_3.1.23_b,3,865
97,179,134,237,633,316,317,0,3,1,ABMrun_3.1.23_b,3,870
98,186,148,230,656,322,334,0,3,1,ABMrun_3.1.23_b,3,886
99,178,134,231,640,309,331,0,3,1,ABMrun_3.1.23_b,3,871
100,169,129,218,655,317,338,0,3,1,ABMrun_3.1.23_b,3,873
101,136,111,169,732,370,362,0,3,1,ABMrun_3.1.23_b,3,901
102,149,117,191,639,317,322,0,3,1,ABMrun_3.1.23_b,3,830
103,155,121,197,585,288,297,0,3,1,ABMrun_3.1.23_b,3,782
104,144,110,184,585,290,295,0,3,1,ABMrun_3.1.23_b,3,769
105,131,102,170,589,299,290,0,3,1,ABMrun_3.1.23_b,3,759
106,127,97,166,564,289,275,0,3,1,ABMrun_3.1.23_b,3,730
107,135,100,168,528,268,260,0,3,1,ABMrun_3.1.23_b,3,696
108,125,97,161,494,245,249,0,3,1,ABMrun_3.1.23_b,3,655
109,125,91,156,474,237,237,0,3,1,ABMrun_3.1.23_b,3,630
110,64,52,81,460,244,216,0,3,1,ABMrun_3.1.23_b,3,541
111,69,55,88,379,196,183,0,3,1,ABMrun_3.1.23_b,3,467
112,68,55,88,341,177,164,0,3,1,ABMrun_3.1.23_b,3,429
113,70,52,85,300,162,138,0,3,1,ABMrun_3.1.23_b,3,385
114,66,49,83,279,146,133,0,3,1,ABMrun_3.1.23_b,3,362
115,62,49,79,251,129,122,0,3,1,ABMrun_3.1.23_b,3,330
116,65,50,78,236,118,118,0,3,1,ABMrun_3.1.23_b,3,314
117,55,44,77,234,118,116,0,3,1,ABMrun_3.1.23_b,3,311
118,58,41,75,223,120,103,0,3,1,ABMrun_3.1.23_b,3,298
119,57,42,77,227,126,101,0,3,1,ABMrun_3.1.23_b,3,304
120,64,54,77,231,122,109,0,3,1,ABMrun_3.1.23_b,3,308
121,59,41,74,210,107,103,0,3,1,ABMrun_3.1.23_b,3,284
122,57,43,74,221,115,106,0,3,1,ABMrun_3.1.23_b,3,295
123,60,43,76,224,116,108,0,3,1,ABMrun_3.1.23_b,3,300
124,63,52,79,227,110,117,0,3,1,ABMrun_3.1.23_b,3,306
125,56,44,74,218,107,111,0,3,1,ABMrun_3.1.23_b,3,292
126,59,47,74,224,118,106,0,3,1,ABMrun_3.1.23_b,3,298
127,57,43,73,212,117,95,0,3,1,ABMrun_3.1.23_b,3,285
128,59,46,74,213,117,96,0,3,1,ABMrun_3.1.23_b,3,287
129,60,48,76,223,120,103,0,3,1,ABMrun_3.1.23_b,3,299
130,56,46,75,230,115,115,0,3,1,ABMrun_3.1.23_b,3,305
131,57,43,73,219,115,104,0,3,1,ABMrun_3.1.23_b,3,292
132,56,45,72,212,103,109,0,3,1,ABMrun_3.1.23_b,3,284
133,58,43,72,208,99,109,0,3,1,ABMrun_3.1.23_b,3,280
134,57,41,72,208,97,111,0,3,1,ABMrun_3.1.23_b,3,280
135,56,43,68,192,91,101,0,3,1,ABMrun_3.1.23_b,3,260
136,56,40,69,192,99,93,0,3,1,ABMrun_3.1.23_b,3,261
137,57,41,71,199,99,100,0,3,1,ABMrun_3.1.23_b,3,270
138,56,39,69,206,102,104,0,3,1,ABMrun_3.1.23_b,3,275
139,54,42,69,193,93,100,0,3,1,ABMrun_3.1.23_b,3,262
140,53,42,68,190,91,99,0,3,1,ABMrun_3.1.23_b,3,258
141,54,45,70,203,90,113,0,3,1,ABMrun_3.1.23_b,3,273
142,60,44,71,212,100,112,0,3,1,ABMrun_3.1.23_b,3,283
143,59,47,74,220,109,111,0,3,1,ABMrun_3.1.23_b,3,294
144,63,49,74,213,105,108,0,3,1,ABMrun_3.1.23_b,3,287
145,53,40,71,207,94,113,0,3,1,ABMrun_3.1.23_b,3,278
146,56,45,73,216,98,118,0,3,1,ABMrun_3.1.23_b,3,289
147,57,42,72,202,88,114,0,3,1,ABMrun_3.1.23_b,3,274
148,58,46,71,195,83,112,0,3,1,ABMrun_3.1.23_b,3,266
149,52,40,68,189,80,109,0,3,1,ABMrun_3.1.23_b,3,257
150,59,42,73,208,92,116,0,3,1,ABMrun_3.1.23_b,3,281
151,95,64,147,223,100,123,1,3,1,ABMrun_3.1.23_b,3,370
152,129,83,179,294,151,143,1,3,1,ABMrun_3.1.23_b,3,473
153,149,97,196,380,200,180,2,3,1,ABMrun_3.1.23_b,3,576
154,159,113,203,464,239,225,3,3,1,ABMrun_3.1.23_b,3,667
155,165,131,204,521,271,250,2,3,1,ABMrun_3.1.23_b,3,725
156,163,120,210,548,287,261,0,3,1,ABMrun_3.1.23_b,3,758
157,168,118,213,584,314,270,0,3,1,ABMrun_3.1.23_b,3,797
158,168,131,216,607,329,278,2,3,1,ABMrun_3.1.23_b,3,823
159,184,139,233,602,321,281,1,3,1,ABMrun_3.1.23_b,3,835
160,180,129,233,634,323,311,1,3,1,ABMrun_3.1.23_b,3,867
161,180,139,229,660,339,321,0,3,1,ABMrun_3.1.23_b,3,889
162,180,135,225,672,344,328,2,3,1,ABMrun_3.1.23_b,3,897
163,179,135,231,649,326,323,1,3,1,ABMrun_3.1.23_b,3,880
164,188,136,234,643,321,322,1,3,1,ABMrun_3.1.23_b,3,877
165,185,133,235,637,325,312,1,3,1,ABMrun_3.1.23_b,3,872
166,171,143,226,655,345,310,0,3,1,ABMrun_3.1.23_b,3,881
167,173,133,226,658,355,303,1,3,1,ABMrun_3.1.23_b,3,884
168,170,135,225,670,354,316,1,3,1,ABMrun_3.1.23_b,3,895
169,174,124,228,654,347,307,1,3,1,ABMrun_3.1.23_b,3,882
170,177,136,220,680,349,331,1,3,1,ABMrun_3.1.23_b,3,900
171,174,129,220,689,343,346,1,3,1,ABMrun_3.1.23_b,3,909
172,181,134,234,640,322,318,0,3,1,ABMrun_3.1.23_b,3,874
173,190,143,228,651,328,323,1,3,1,ABMrun_3.1.23_b,3,879
174,187,138,232,642,310,332,1,3,1,ABMrun_3.1.23_b,3,874
175,187,147,234,641,309,332,2,3,1,ABMrun_3.1.23_b,3,875
176,158,128,211,728,355,373,1,3,1,ABMrun_3.1.23_b,3,939
177,175,130,230,653,331,322,1,3,1,ABMrun_3.1.23_b,3,883
178,186,136,233,646,328,318,1,3,1,ABMrun_3.1.23_b,3,879
179,176,132,224,668,358,310,0,3,1,ABMrun_3.1.23_b,3,892
180,178,139,232,644,338,306,0,3,1,ABMrun_3.1.23_b,3,876
181,171,135,224,675,357,318,0,3,1,ABMrun_3.1.23_b,3,899
182,169,134,224,674,334,340,0,3,1,ABMrun_3.1.23_b,3,898
183,180,138,232,643,328,315,0,3,1,ABMrun_3.1.23_b,3,875
184,171,137,215,691,339,352,1,3,1,ABMrun_3.1.23_b,3,906
185,175,133,227,662,318,344,1,3,1,ABMrun_3.1.23_b,3,889
186,176,134,231,655,321,334,1,3,1,ABMrun_3.1.23_b,3,886
187,181,141,230,648,326,322,0,3,1,ABMrun_3.1.23_b,3,878
188,185,143,234,643,325,318,1,3,1,ABMrun_3.1.23_b,3,877
189,175,137,224,673,329,344,2,3,1,ABMrun_3.1.23_b,3,897
190,172,139,225,660,310,350,3,3,1,ABMrun_3.1.23_b,3,885
191,167,131,222,669,311,358,0,3,1,ABMrun_3.1.23_b,3,891
192,174,128,229,661,320,341,1,3,1,ABMrun_3.1.23_b,3,890
193,175,134,220,682,330,352,2,3,1,ABMrun_3.1.23_b,3,902
194,180,136,232,652,308,344,0,3,1,ABMrun_3.1.23_b,3,884
195,185,148,233,641,302,339,1,3,1,ABMrun_3.1.23_b,3,874
196,178,132,227,660,332,328,0,3,1,ABMrun_3.1.23_b,3,887
197,170,138,220,675,345,330,1,3,1,ABMrun_3.1.23_b,3,895
198,173,137,224,675,333,342,0,3,1,ABMrun_3.1.23_b,3,899
199,179,142,231,650,341,309,1,3,1,ABMrun_3.1.23_b,3,881
200,190,145,231,655,345,310,1,3,1,ABMrun_3.1.23_b,3,886
201,166,134,212,716,374,342,1,3,1,ABMrun_3.1.23_b,3,928
202,167,131,219,681,356,325,1,3,1,ABMrun_3.1.23_b,3,900
203,186,148,234,638,330,308,0,3,1,ABMrun_3.1.23_b,3,872
204,175,132,227,663,318,345,0,3,1,ABMrun_3.1.23_b,3,890
205,174,138,223,666,317,349,0,3,1,ABMrun_3.1.23_b,3,889
206,171,135,226,659,319,340,1,3,1,ABMrun_3.1.23_b,3,885
207,179,140,224,673,332,341,2,3,1,ABMrun_3.1.23_b,3,897
208,175,139,225,671,319,352,2,3,1,ABMrun_3.1.23_b,3,896
209,180,136,232,645,328,317,3,3,1,ABMrun_3.1.23_b,3,877
210,177,141,230,649,324,325,1,3,1,ABMrun_3.1.23_b,3,879
211,177,134,231,649,343,306,1,3,1,ABMrun_3.1.23_b,3,880
212,176,140,225,662,334,328,1,3,1,ABMrun_3.1.23_b,3,887
213,175,138,228,657,328,329,1,3,1,ABMrun_3.1.23_b,3,885
214,174,146,226,665,338,327,1,3,1,ABMrun_3.1.23_b,3,891
215,178,136,225,663,337,326,0,3,1,ABMrun_3.1.23_b,3,888
216,170,131,221,679,351,328,0,3,1,ABMrun_3.1.23_b,3,900
217,177,140,222,680,359,321,1,3,1,ABMrun_3.1.23_b,3,902
218,175,139,223,674,355,319,0,3,1,ABMrun_3.1.23_b,3,897
219,175,127,216,686,358,328,1,3,1,ABMrun_3.1.23_b,3,902
220,178,131,231,645,337,308,2,3,1,ABMrun_3.1.23_b,3,876
221,184,145,232,644,322,322,1,3,1,ABMrun_3.1.23_b,3,876
222,181,143,221,681,336,345,1,3,1,ABMrun_3.1.23_b,3,902
223,164,125,210,708,338,370,1,3,1,ABMrun_3.1.23_b,3,918
224,174,132,220,673,329,344,2,3,1,ABMrun_3.1.23_b,3,893
225,178,138,230,653,309,344,1,3,1,ABMrun_3.1.23_b,3,883
226,160,133,217,688,334,354,1,3,1,ABMrun_3.1.23_b,3,905
227,168,124,220,672,340,332,0,3,1,ABMrun_3.1.23_b,3,892
228,174,140,226,659,340,319,0,3,1,ABMrun_3.1.23_b,3,885
229,180,129,226,657,341,316,1,3,1,ABMrun_3.1.23_b,3,883
230,180,136,226,667,344,323,2,3,1,ABMrun_3.1.23_b,3,893
231,177,140,228,655,336,319,3,3,1,ABMrun_3.1.23_b,3,883
232,180,147,227,667,326,341,3,3,1,ABMrun_3.1.23_b,3,894
233,172,134,221,675,328,347,2,3,1,ABMrun_3.1.23_b,3,896
234,176,134,226,666,329,337,1,3,1,ABMrun_3.1.23_b,3,892
235,181,133,232,639,322,317,1,3,1,ABMrun_3.1.23_b,3,871
236,177,142,231,650,312,338,1,3,1,ABMrun_3.1.23_b,3,881
237,166,131,222,671,323,348,0,3,1,ABMrun_3.1.23_b,3,893
238,166,136,221,680,332,348,2,3,1,ABMrun_3.1.23_b,3,901
239,180,138,224,669,314,355,1,3,1,ABMrun_3.1.23_b,3,893
240,178,133,228,657,321,336,0,3,1,ABMrun_3.1.23_b,3,885
241,181,140,229,654,316,338,0,3,1,ABMrun_3.1.23_b,3,883
242,173,132,229,654,322,332,1,3,1,ABMrun_3.1.23_b,3,883
243,174,128,229,652,331,321,1,3,1,ABMrun_3.1.23_b,3,881
244,168,130,225,668,331,337,1,3,1,ABMrun_3.1.23_b,3,893
245,173,129,227,661,308,353,1,3,1,ABMrun_3.1.23_b,3,888
246,178,133,229,653,299,354,2,3,1,ABMrun_3.1.23_b,3,882
247,180,149,231,642,299,343,2,3,1,ABMrun_3.1.23_b,3,873
248,173,130,222,668,335,333,2,3,1,ABMrun_3.1.23_b,3,890
249,169,130,219,678,346,332,1,3,1,ABMrun_3.1.23_b,3,897
250,185,145,226,663,327,336,1,3,1,ABMrun_3.1.23_b,3,889
251,173,137,218,692,341,351,2,3,1,ABMrun_3.1.23_b,3,910
252,183,143,220,681,328,353,1,3,1,ABMrun_3.1.23_b,3,901
253,182,137,235,637,317,320,2,3,1,ABMrun_3.1.23_b,3,872
254,181,130,229,654,334,320,0,3,1,ABMrun_3.1.23_b,3,883
255,175,136,220,689,344,345,3,3,1,ABMrun_3.1.23_b,3,909
256,180,136,229,652,300,352,2,3,1,ABMrun_3.1.23_b,3,881
257,177,145,228,659,298,361,0,3,1,ABMrun_3.1.23_b,3,887
258,166,123,219,680,325,355,2,3,1,ABMrun_3.1.23_b,3,899
259,169,130,222,664,313,351,2,3,1,ABMrun_3.1.23_b,3,886
260,180,151,231,644,300,344,0,3,1,ABMrun_3.1.23_b,3,875
261,176,136,228,659,310,349,1,3,1,ABMrun_3.1.23_b,3,887
262,170,132,221,676,313,363,2,3,1,ABMrun_3.1.23_b,3,897
263,183,140,227,659,325,334,2,3,1,ABMrun_3.1.23_b,3,886
264,178,145,227,657,326,331,1,3,1,ABMrun_3.1.23_b,3,884
265,179,136,225,682,339,343,0,3,1,ABMrun_3.1.23_b,3,907
266,171,137,227,662,321,341,0,3,1,ABMrun_3.1.23_b,3,889
267,166,132,208,704,358,346,1,3,1,ABMrun_3.1.23_b,3,912
268,178,135,221,684,341,343,0,3,1,ABMrun_3.1.23_b,3,905
269,179,145,228,657,320,337,0,3,1,ABMrun_3.1.23_b,3,885
270,176,140,225,667,342,325,3,3,1,ABMrun_3.1.23_b,3,892
271,177,135,227,662,336,326,1,3,1,ABMrun_3.1.23_b,3,889
272,177,137,231,650,325,325,2,3,1,ABMrun_3.1.23_b,3,881
273,164,131,220,678,343,335,0,3,1,ABMrun_3.1.23_b,3,898
274,175,137,228,661,338,323,1,3,1,ABMrun_3.1.23_b,3,889
275,172,140,227,660,323,337,1,3,1,ABMrun_3.1.23_b,3,887
276,164,137,208,714,344,370,1,3,1,ABMrun_3.1.23_b,3,922
277,171,137,217,689,351,338,1,3,1,ABMrun_3.1.23_b,3,906
278,173,139,225,657,325,332,0,3,1,ABMrun_3.1.23_b,3,882
279,179,139,224,661,339,322,1,3,1,ABMrun_3.1.23_b,3,885
280,182,139,223,674,356,318,2,3,1,ABMrun_3.1.23_b,3,897
281,165,132,220,684,350,334,0,3,1,ABMrun_3.1.23_b,3,904
282,180,136,227,656,334,322,1,3,1,ABMrun_3.1.23_b,3,883
283,183,149,227,660,344,316,1,3,1,ABMrun_3.1.23_b,3,887
284,170,139,222,677,342,335,0,3,1,ABMrun_3.1.23_b,3,899
285,175,137,223,672,344,328,1,3,1,ABMrun_3.1.23_b,3,895
286,176,139,230,648,318,330,1,3,1,ABMrun_3.1.23_b,3,878
287,172,127,222,666,343,323,0,3,1,ABMrun_3.1.23_b,3,888
288,163,133,218,684,354,330,0,3,1,ABMrun_3.1.23_b,3,902
289,174,128,223,675,354,321,1,3,1,ABMrun_3.1.23_b,3,898
290,167,125,220,677,357,320,0,3,1,ABMrun_3.1.23_b,3,897
291,171,129,223,668,357,311,0,3,1,ABMrun_3.1.23_b,3,891
292,176,133,230,655,344,311,1,3,1,ABMrun_3.1.23_b,3,885
293,168,134,227,663,357,306,0,3,1,ABMrun_3.1.23_b,3,890
294,179,141,225,674,349,325,0,3,1,ABMrun_3.1.23_b,3,899
295,174,132,222,671,345,326,1,3,1,ABMrun_3.1.23_b,3,893
296,175,134,218,682,343,339,1,3,1,ABMrun_3.1.23_b,3,900
297,167,132,226,664,340,324,0,3,1,ABMrun_3.1.23_b,3,890
298,179,135,220,682,348,334,0,3,1,ABMrun_3.1.23_b,3,902
299,177,142,221,672,336,336,0,3,1,ABMrun_3.1.23_b,3,893
300,174,129,225,666,341,325,1,3,1,ABMrun_3.1.23_b,3,891
301,166,131,205,718,373,345,1,3,1,ABMrun_3.1.23_b,3,923
302,185,138,226,664,342,322,3,3,1,ABMrun_3.1.23_b,3,890
303,177,137,221,680,340,340,1,3,1,ABMrun_3.1.23_b,3,901
304,171,135,218,681,348,333,2,3,1,ABMrun_3.1.23_b,3,899
305,174,138,225,662,328,334,1,3,1,ABMrun_3.1.23_b,3,887
306,173,136,226,667,333,334,1,3,1,ABMrun_3.1.23_b,3,893
307,171,129,220,675,333,342,1,3,1,ABMrun_3.1.23_b,3,895
308,166,132,221,673,331,342,0,3,1,ABMrun_3.1.23_b,3,894
309,177,138,225,665,331,334,1,3,1,ABMrun_3.1.23_b,3,890
310,174,129,222,670,313,357,1,3,1,ABMrun_3.1.23_b,3,892
311,176,132,227,667,304,363,2,3,1,ABMrun_3.1.23_b,3,894
312,172,134,227,659,299,360,1,3,1,ABMrun_3.1.23_b,3,886
313,166,132,221,677,312,365,1,3,1,ABMrun_3.1.23_b,3,898
314,173,130,221,674,327,347,0,3,1,ABMrun_3.1.23_b,3,895
315,176,145,227,663,326,337,2,3,1,ABMrun_3.1.23_b,3,890
316,174,129,223,668,331,337,1,3,1,ABMrun_3.1.23_b,3,891
317,179,138,231,640,320,320,1,3,1,ABMrun_3.1.23_b,3,871
318,166,130,220,672,334,338,3,3,1,ABMrun_3.1.23_b,3,892
319,185,144,232,642,314,328,1,3,1,ABMrun_3.1.23_b,3,874
320,178,141,225,669,330,339,2,3,1,ABMrun_3.1.23_b,3,894
321,172,141,223,679,320,359,1,3,1,ABMrun_3.1.23_b,3,902
322,182,135,227,660,331,329,0,3,1,ABMrun_3.1.23_b,3,887
323,165,135,214,696,333,363,1,3,1,ABMrun_3.1.23_b,3,910
324,174,136,223,669,328,341,1,3,1,ABMrun_3.1.23_b,3,892
325,175,138,230,643,312,331,0,3,1,ABMrun_3.1.23_b,3,873
326,164,137,216,691,337,354,1,3,1,ABMrun_3.1.23_b,3,907
327,176,144,225,664,316,348,1,3,1,ABMrun_3.1.23_b,3,889
328,170,128,219,678,329,349,1,3,1,ABMrun_3.1.23_b,3,897
329,177,131,228,657,332,325,0,3,1,ABMrun_3.1.23_b,3,885
330,173,128,226,676,332,344,1,3,1,ABMrun_3.1.23_b,3,902
331,163,134,221,676,339,337,1,3,1,ABMrun_3.1.23_b,3,897
332,165,124,213,697,359,338,1,3,1,ABMrun_3.1.23_b,3,910
333,177,142,225,661,336,325,2,3,1,ABMrun_3.1.23_b,3,886
334,173,143,225,666,349,317,1,3,1,ABMrun_3.1.23_b,3,891
335,178,133,233,643,329,314,1,3,1,ABMrun_3.1.23_b,3,876
336,175,137,225,661,329,332,2,3,1,ABMrun_3.1.23_b,3,886
337,171,136,222,678,337,341,1,3,1,ABMrun_3.1.23_b,3,900
338,158,118,212,700,354,346,0,3,1,ABMrun_3.1.23_b,3,912
339,166,130,210,703,360,343,0,3,1,ABMrun_3.1.23_b,3,913
340,176,141,224,667,343,324,0,3,1,ABMrun_3.1.23_b,3,891
341,176,143,224,662,340,322,1,3,1,ABMrun_3.1.23_b,3,886
342,171,137,220,670,340,330,2,3,1,ABMrun_3.1.23_b,3,890
343,165,131,216,689,332,357,0,3,1,ABMrun_3.1.23_b,3,905
344,169,135,220,677,321,356,1,3,1,ABMrun_3.1.23_b,3,897
345,171,134,225,666,298,368,0,3,1,ABMrun_3.1.23_b,3,891
346,167,126,223,670,291,379,0,3,1,ABMrun_3.1.23_b,3,893
347,170,132,220,677,304,373,1,3,1,ABMrun_3.1.23_b,3,897
348,172,135,223,674,327,347,1,3,1,ABMrun_3.1.23_b,3,897
349,179,137,226,667,342,325,1,3,1,ABMrun_3.1.23_b,3,893
350,178,134,229,657,330,327,0,3,1,ABMrun_3.1.23_b,3,886
1,13,13,17,612,293,319,0,1,1,ABMrun_3.1.23_b,4,629
2,91,83,108,878,412,466,0,1,1,ABMrun_3.1.23_b,4,986
3,124,107,163,795,387,408,0,1,1,ABMrun_3.1.23_b,4,958
4,156,131,199,733,372,361,0,1,1,ABMrun_3.1.23_b,4,932
5,178,142,224,675,342,333,0,1,1,ABMrun_3.1.23_b,4,899
6,185,135,239,618,316,302,0,1,1,ABMrun_3.1.23_b,4,857
7,189,136,242,616,298,318,0,1,1,ABMrun_3.1.23_b,4,858
8,188,139,239,621,325,296,0,1,1,ABMrun_3.1.23_b,4,860
9,185,137,239,626,322,304,0,1,1,ABMrun_3.1.23_b,4,865
10,183,143,233,643,336,307,0,1,1,ABMrun_3.1.23_b,4,876
11,187,138,228,656,348,308,0,1,1,ABMrun_3.1.23_b,4,884
12,185,151,230,668,352,316,0,1,1,ABMrun_3.1.23_b,4,898
13,174,129,226,661,355,306,0,1,1,ABMrun_3.1.23_b,4,887
14,178,142,232,648,336,312,0,1,1,ABMrun_3.1.23_b,4,880
15,168,130,222,679,352,327,0,1,1,ABMrun_3.1.23_b,4,901
16,167,134,224,675,346,329,0,1,1,ABMrun_3.1.23_b,4,899
17,182,134,236,647,321,326,0,1,1,ABMrun_3.1.23_b,4,883
18,183,144,236,646,308,338,0,1,1,ABMrun_3.1.23_b,4,882
19,181,144,232,644,313,331,0,1,1,ABMrun_3.1.23_b,4,876
20,186,144,238,632,307,325,0,1,1,ABMrun_3.1.23_b,4,870
21,181,144,239,624,292,332,0,1,1,ABMrun_3.1.23_b,4,863
22,181,139,231,651,314,337,0,1,1,ABMrun_3.1.23_b,4,882
23,173,131,228,662,316,346,0,1,1,ABMrun_3.1.23_b,4,890
24,179,142,229,657,307,350,0,1,1,ABMrun_3.1.23_b,4,886
25,173,129,232,653,311,342,0,1,1,ABMrun_3.1.23_b,4,885
26,161,138,207,719,353,366,0,1,1,ABMrun_3.1.23_b,4,926
27,174,141,228,653,315,338,0,1,1,ABMrun_3.1.23_b,4,881
28,183,138,235,637,314,323,0,1,1,ABMrun_3.1.23_b,4,872
29,181,147,233,651,329,322,0,1,1,ABMrun_3.1.23_b,4,884
30,172,133,229,660,336,324,0,1,1,ABMrun_3.1.23_b,4,889
31,183,143,232,651,327,324,0,1,1,ABMrun_3.1.23_b,4,883
32,180,133,230,654,336,318,0,1,1,ABMrun_3.1.23_b,4,884
33,178,135,228,657,321,336,0,1,1,ABMrun_3.1.23_b,4,885
34,173,141,225,663,327,336,0,1,1,ABMrun_3.1.23_b,4,888
35,176,135,232,648,330,318,0,1,1,ABMrun_3.1.23_b,4,880
36,171,141,230,654,331,323,0,1,1,ABMrun_3.1.23_b,4,884
37,175,132,231,647,327,320,0,1,1,ABMrun_3.1.23_b,4,878
38,184,136,229,647,339,308,0,1,1,ABMrun_3.1.23_b,4,876
39,176,142,227,671,336,335,0,1,1,ABMrun_3.1.23_b,4,898
40,177,134,229,659,336,323,0,1,1,ABMrun_3.1.23_b,4,888
41,178,135,235,637,310,327,0,1,1,ABMrun_3.1.23_b,4,872
42,179,139,226,660,331,329,0,1,1,ABMrun_3.1.23_b,4,886
43,175,131,227,674,351,323,0,1,1,ABMrun_3.1.23_b,4,901
44,177,141,231,655,332,323,0,1,1,ABMrun_3.1.23_b,4,886
45,179,136,228,663,344,319,0,1,1,ABMrun_3.1.23_b,4,891
46,177,133,233,650,334,316,0,1,1,ABMrun_3.1.23_b,4,883
47,181,136,236,631,314,317,0,1,1,ABMrun_3.1.23_b,4,867
48,189,141,235,635,320,315,0,1,1,ABMrun_3.1.23_b,4,870
49,189,138,239,629,315,314,0,1,1,ABMrun_3.1.23_b,4,868
50,181,137,231,643,339,304,0,1,1,ABMrun_3.1.23_b,4,874
51,171,133,222,692,355,337,0,1,1,ABMrun_3.1.23_b,4,914
52,178,134,229,658,333,325,0,1,1,ABMrun_3.1.23_b,4,887
53,180,139,233,657,332,325,0,1,1,ABMrun_3.1.23_b,4,890
54,181,139,233,652,327,325,0,1,1,ABMrun_3.1.23_b,4,885
55,184,143,229,658,339,319,0,1,1,ABMrun_3.1.23_b,4,887
56,190,140,240,631,323,308,0,1,1,ABMrun_3.1.23_b,4,871
57,183,139,236,626,324,302,0,1,1,ABMrun_3.1.23_b,4,862
58,177,140,232,642,329,313,0,1,1,ABMrun_3.1.23_b,4,874
59,177,139,230,659,333,326,0,1,1,ABMrun_3.1.23_b,4,889
60,173,134,226,674,348,326,0,1,1,ABMrun_3.1.23_b,4,900
61,180,135,236,632,321,311,0,1,1,ABMrun_3.1.23_b,4,868
62,182,139,225,666,338,328,0,1,1,ABMrun_3.1.23_b,4,891
63,174,135,229,657,322,335,0,1,1,ABMrun_3.1.23_b,4,886
64,187,148,234,642,315,327,0,1,1,ABMrun_3.1.23_b,4,876
65,185,147,230,653,317,336,0,1,1,ABMrun_3.1.23_b,4,883
66,178,134,229,657,321,336,0,1,1,ABMrun_3.1.23_b,4,886
67,181,136,236,640,302,338,0,1,1,ABMrun_3.1.23_b,4,876
68,186,141,231,644,316,328,0,1,1,ABMrun_3.1.23_b,4,875
69,172,131,228,674,347,327,0,1,1,ABMrun_3.1.23_b,4,902
70,180,138,228,663,333,330,0,1,1,ABMrun_3.1.23_b,4,891
71,181,142,226,665,329,336,0,1,1,ABMrun_3.1.23_b,4,891
72,176,139,224,676,351,325,0,1,1,ABMrun_3.1.23_b,4,900
73,184,139,229,653,322,331,0,1,1,ABMrun_3.1.23_b,4,882
74,175,131,227,669,321,348,0,1,1,ABMrun_3.1.23_b,4,896
75,171,137,224,678,331,347,0,1,1,ABMrun_3.1.23_b,4,902
76,158,129,212,715,362,353,0,1,1,ABMrun_3.1.23_b,4,927
77,182,140,232,645,326,319,0,1,1,ABMrun_3.1.23_b,4,877
78,175,129,229,660,346,314,0,1,1,ABMrun_3.1.23_b,4,889
79,190,142,235,645,336,309,0,1,1,ABMrun_3.1.23_b,4,880
80,184,134,239,626,318,308,0,1,1,ABMrun_3.1.23_b,4,865
81,183,134,234,655,332,323,0,1,1,ABMrun_3.1.23_b,4,889
82,169,136,224,672,332,340,0,1,1,ABMrun_3.1.23_b,4,896
83,185,135,233,640,305,335,0,1,1,ABMrun_3.1.23_b,4,873
84,188,142,232,642,308,334,0,1,1,ABMrun_3.1.23_b,4,874
85,175,142,231,661,323,338,0,1,1,ABMrun_3.1.23_b,4,892
86,182,141,236,650,327,323,0,1,1,ABMrun_3.1.23_b,4,886
87,189,141,239,615,319,296,0,1,1,ABMrun_3.1.23_b,4,854
88,179,134,233,635,340,295,0,1,1,ABMrun_3.1.23_b,4,868
89,186,136,232,654,343,311,0,1,1,ABMrun_3.1.23_b,4,886
90,181,136,232,646,332,314,0,1,1,ABMrun_3.1.23_b,4,878
91,173,135,232,651,329,322,0,1,1,ABMrun_3.1.23_b,4,883
92,176,132,226,671,324,347,0,1,1,ABMrun_3.1.23_b,4,897
93,187,136,239,635,312,323,0,1,1,ABMrun_3.1.23_b,4,874
94,175,135,228,662,332,330,0,1,1,ABMrun_3.1.23_b,4,890
95,171,135,223,682,329,353,0,1,1,ABMrun_3.1.23_b,4,905
96,177,136,227,662,318,344,0,1,1,ABMrun_3.1.23_b,4,889
97,169,131,218,684,332,352,0,1,1,ABMrun_3.1.23_b,4,902
98,182,136,227,659,327,332,0,1,1,ABMrun_3.1.23_b,4,886
99,186,143,236,637,307,330,0,1,1,ABMrun_3.1.23_b,4,873
100,175,130,222,645,320,325,0,1,1,ABMrun_3.1.23_b,4,867
101,146,119,185,696,351,345,0,1,1,ABMrun_3.1.23_b,4,881
102,155,119,199,622,316,306,0,1,1,ABMrun_3.1.23_b,4,821
103,143,113,191,613,301,312,0,1,1,ABMrun_3.1.23_b,4,804
104,138,108,179,600,291,309,0,1,1,ABMrun_3.1.23_b,4,779
105,139,114,178,573,262,311,0,1,1,ABMrun_3.1.23_b,4,751
106,133,102,177,535,251,284,0,1,1,ABMrun_3.1.23_b,4,712
107,133,112,171,510,237,273,0,1,1,ABMrun_3.1.23_b,4,681
108,128,104,165,491,236,255,0,1,1,ABMrun_3.1.23_b,4,656
109,118,101,153,496,243,253,0,1,1,ABMrun_3.1.23_b,4,649
110,60,53,78,459,236,223,0,1,1,ABMrun_3.1.23_b,4,537
111,67,57,86,371,189,182,0,1,1,ABMrun_3.1.23_b,4,457
112,71,57,87,333,180,153,0,1,1,ABMrun_3.1.23_b,4,420
113,67,50,86,286,151,135,0,1,1,ABMrun_3.1.23_b,4,372
114,65,51,82,272,137,135,0,1,1,ABMrun_3.1.23_b,4,354
115,66,50,80,252,122,130,0,1,1,ABMrun_3.1.23_b,4,332
116,61,45,80,246,119,127,0,1,1,ABMrun_3.1.23_b,4,326
117,60,45,75,235,122,113,0,1,1,ABMrun_3.1.23_b,4,310
118,61,44,76,224,121,103,0,1,1,ABMrun_3.1.23_b,4,300
119,57,46,75,221,114,107,0,1,1,ABMrun_3.1.23_b,4,296
120,59,46,77,227,108,119,0,1,1,ABMrun_3.1.23_b,4,304
121,55,44,73,208,106,102,0,1,1,ABMrun_3.1.23_b,4,281
122,54,44,72,201,94,107,0,1,1,ABMrun_3.1.23_b,4,273
123,59,42,71,203,97,106,0,1,1,ABMrun_3.1.23_b,4,274
124,59,52,73,216,99,117,0,1,1,ABMrun_3.1.23_b,4,289
125,62,49,76,209,91,118,0,1,1,ABMrun_3.1.23_b,4,285
126,59,44,75,221,102,119,0,1,1,ABMrun_3.1.23_b,4,296
127,58,42,75,224,111,113,0,1,1,ABMrun_3.1.23_b,4,299
128,56,44,75,218,115,103,0,1,1,ABMrun_3.1.23_b,4,293
129,54,42,74,217,107,110,0,1,1,ABMrun_3.1.23_b,4,291
130,55,39,71,210,95,115,0,1,1,ABMrun_3.1.23_b,4,281
131,57,43,73,213,97,116,0,1,1,ABMrun_3.1.23_b,4,286
132,59,46,74,216,101,115,0,1,1,ABMrun_3.1.23_b,4,290
133,54,42,72,213,110,103,0,1,1,ABMrun_3.1.23_b,4,285
134,55,42,73,215,111,104,0,1,1,ABMrun_3.1.23_b,4,288
135,60,46,72,211,114,97,0,1,1,ABMrun_3.1.23_b,4,283
136,58,43,77,223,116,107,0,1,1,ABMrun_3.1.23_b,4,300
137,58,44,75,221,114,107,0,1,1,ABMrun_3.1.23_b,4,296
138,58,43,72,204,104,100,0,1,1,ABMrun_3.1.23_b,4,276
139,57,44,71,203,106,97,0,1,1,ABMrun_3.1.23_b,4,274
140,51,40,68,189,92,97,0,1,1,ABMrun_3.1.23_b,4,257
141,55,43,70,198,97,101,0,1,1,ABMrun_3.1.23_b,4,268
142,53,42,70,202,95,107,0,1,1,ABMrun_3.1.23_b,4,272
143,56,46,71,202,93,109,0,1,1,ABMrun_3.1.23_b,4,273
144,56,42,69,194,97,97,0,1,1,ABMrun_3.1.23_b,4,263
145,57,47,72,202,94,108,0,1,1,ABMrun_3.1.23_b,4,274
146,56,43,69,196,103,93,0,1,1,ABMrun_3.1.23_b,4,265
147,55,41,71,200,105,95,0,1,1,ABMrun_3.1.23_b,4,271
148,57,42,71,204,104,100,0,1,1,ABMrun_3.1.23_b,4,275
149,53,37,68,196,107,89,0,1,1,ABMrun_3.1.23_b,4,264
150,54,43,67,186,85,101,0,1,1,ABMrun_3.1.23_b,4,253
151,122,90,176,289,128,161,65,1,1,ABMrun_3.1.23_b,4,465
152,142,96,191,358,171,187,33,1,1,ABMrun_3.1.23_b,4,549
153,153,114,197,425,205,220,22,1,1,ABMrun_3.1.23_b,4,622
154,151,114,197,496,242,254,6,1,1,ABMrun_3.1.23_b,4,693
155,150,112,199,539,271,268,2,1,1,ABMrun_3.1.23_b,4,738
156,156,111,206,556,286,270,1,1,1,ABMrun_3.1.23_b,4,762
157,170,122,220,544,280,264,0,1,1,ABMrun_3.1.23_b,4,764
158,175,130,226,568,289,279,0,1,1,ABMrun_3.1.23_b,4,794
159,171,136,224,623,317,306,0,1,1,ABMrun_3.1.23_b,4,847
160,188,139,230,657,328,329,0,1,1,ABMrun_3.1.23_b,4,887
161,174,139,223,678,333,345,0,1,1,ABMrun_3.1.23_b,4,901
162,170,140,225,665,321,344,0,1,1,ABMrun_3.1.23_b,4,890
163,176,133,229,659,327,332,0,1,1,ABMrun_3.1.23_b,4,888
164,179,142,226,657,324,333,0,1,1,ABMrun_3.1.23_b,4,883
165,176,137,231,656,328,328,0,1,1,ABMrun_3.1.23_b,4,887
166,178,132,230,653,334,319,0,1,1,ABMrun_3.1.23_b,4,883
167,181,134,225,675,359,316,0,1,1,ABMrun_3.1.23_b,4,900
168,182,135,227,658,357,301,0,1,1,ABMrun_3.1.23_b,4,885
169,172,134,218,688,359,329,0,1,1,ABMrun_3.1.23_b,4,906
170,170,135,225,659,336,323,0,1,1,ABMrun_3.1.23_b,4,884
171,178,138,225,665,318,347,0,1,1,ABMrun_3.1.23_b,4,890
172,170,149,215,693,329,364,0,1,1,ABMrun_3.1.23_b,4,908
173,183,134,230,653,308,345,0,1,1,ABMrun_3.1.23_b,4,883
174,164,128,220,680,310,370,0,1,1,ABMrun_3.1.23_b,4,900
175,171,138,223,665,313,352,0,1,1,ABMrun_3.1.23_b,4,888
176,162,122,214,700,347,353,0,1,1,ABMrun_3.1.23_b,4,914
177,162,127,213,696,335,361,0,1,1,ABMrun_3.1.23_b,4,909
178,178,131,227,655,314,341,0,1,1,ABMrun_3.1.23_b,4,882
179,177,142,227,668,328,340,0,1,1,ABMrun_3.1.23_b,4,895
180,180,132,230,647,325,322,0,1,1,ABMrun_3.1.23_b,4,877
181,175,136,230,656,313,343,0,1,1,ABMrun_3.1.23_b,4,886
182,182,139,230,657,314,343,0,1,1,ABMrun_3.1.23_b,4,887
183,166,136,217,685,320,365,0,1,1,ABMrun_3.1.23_b,4,902
184,175,143,224,670,316,354,0,1,1,ABMrun_3.1.23_b,4,894
185,175,139,227,654,316,338,0,1,1,ABMrun_3.1.23_b,4,881
186,167,125,222,671,320,351,0,1,1,ABMrun_3.1.23_b,4,893
187,184,143,232,647,317,330,0,1,1,ABMrun_3.1.23_b,4,879
188,175,134,227,657,320,337,0,1,1,ABMrun_3.1.23_b,4,884
189,169,135,219,679,360,319,0,1,1,ABMrun_3.1.23_b,4,898
190,169,131,213,692,375,317,0,1,1,ABMrun_3.1.23_b,4,905
191,180,133,224,671,366,305,0,1,1,ABMrun_3.1.23_b,4,895
192,184,138,231,643,343,300,0,1,1,ABMrun_3.1.23_b,4,874
193,173,124,230,646,339,307,0,1,1,ABMrun_3.1.23_b,4,876
194,180,142,227,662,341,321,0,1,1,ABMrun_3.1.23_b,4,889
195,176,134,228,662,339,323,0,1,1,ABMrun_3.1.23_b,4,890
196,180,134,227,663,333,330,0,1,1,ABMrun_3.1.23_b,4,890
197,180,133,228,662,358,304,0,1,1,ABMrun_3.1.23_b,4,890
198,182,138,230,653,333,320,0,1,1,ABMrun_3.1.23_b,4,883
199,174,141,232,659,320,339,0,1,1,ABMrun_3.1.23_b,4,891
200,180,139,230,656,332,324,0,1,1,ABMrun_3.1.23_b,4,886
201,162,127,211,701,360,341,0,1,1,ABMrun_3.1.23_b,4,912
202,179,124,232,637,334,303,0,1,1,ABMrun_3.1.23_b,4,869
203,171,130,227,652,343,309,0,1,1,ABMrun_3.1.23_b,4,879
204,171,136,223,675,349,326,0,1,1,ABMrun_3.1.23_b,4,898
205,180,138,223,673,352,321,0,1,1,ABMrun_3.1.23_b,4,896
206,178,136,230,648,323,325,0,1,1,ABMrun_3.1.23_b,4,878
207,171,136,232,640,310,330,0,1,1,ABMrun_3.1.23_b,4,872
208,174,130,226,670,321,349,0,1,1,ABMrun_3.1.23_b,4,896
209,178,139,227,657,319,338,0,1,1,ABMrun_3.1.23_b,4,884
210,175,139,221,678,334,344,0,1,1,ABMrun_3.1.23_b,4,899
211,174,133,224,663,330,333,0,1,1,ABMrun_3.1.23_b,4,887
212,177,141,224,663,324,339,0,1,1,ABMrun_3.1.23_b,4,887
213,166,127,222,672,316,356,0,1,1,ABMrun_3.1.23_b,4,894
214,176,137,225,668,329,339,0,1,1,ABMrun_3.1.23_b,4,893
215,167,139,219,689,341,348,0,1,1,ABMrun_3.1.23_b,4,908
216,175,135,226,665,331,334,0,1,1,ABMrun_3.1.23_b,4,891
217,175,140,215,689,339,350,0,1,1,ABMrun_3.1.23_b,4,904
218,183,140,233,636,302,334,0,1,1,ABMrun_3.1.23_b,4,869
219,174,133,230,642,305,337,0,1,1,ABMrun_3.1.23_b,4,872
220,177,142,223,669,339,330,0,1,1,ABMrun_3.1.23_b,4,892
221,179,144,224,665,356,309,0,1,1,ABMrun_3.1.23_b,4,889
222,174,136,222,672,344,328,0,1,1,ABMrun_3.1.23_b,4,894
223,176,136,221,674,338,336,0,1,1,ABMrun_3.1.23_b,4,895
224,174,142,225,669,320,349,0,1,1,ABMrun_3.1.23_b,4,894
225,178,141,227,666,315,351,0,1,1,ABMrun_3.1.23_b,4,893
226,162,128,204,717,332,385,0,1,1,ABMrun_3.1.23_b,4,921
227,160,126,221,670,317,353,0,1,1,ABMrun_3.1.23_b,4,891
228,173,134,223,665,308,357,0,1,1,ABMrun_3.1.23_b,4,888
229,188,145,229,645,312,333,0,1,1,ABMrun_3.1.23_b,4,874
230,171,135,221,677,329,348,0,1,1,ABMrun_3.1.23_b,4,898
231,170,135,214,697,345,352,0,1,1,ABMrun_3.1.23_b,4,911
232,173,140,228,653,322,331,0,1,1,ABMrun_3.1.23_b,4,881
233,174,131,228,660,338,322,0,1,1,ABMrun_3.1.23_b,4,888
234,181,139,229,655,335,320,0,1,1,ABMrun_3.1.23_b,4,884
235,170,130,230,643,325,318,0,1,1,ABMrun_3.1.23_b,4,873
236,164,126,220,674,337,337,0,1,1,ABMrun_3.1.23_b,4,894
237,176,132,224,669,338,331,0,1,1,ABMrun_3.1.23_b,4,893
238,180,134,228,669,346,323,0,1,1,ABMrun_3.1.23_b,4,897
239,175,132,228,654,346,308,0,1,1,ABMrun_3.1.23_b,4,882
240,186,138,228,655,320,335,0,1,1,ABMrun_3.1.23_b,4,883
241,180,137,230,645,321,324,0,1,1,ABMrun_3.1.23_b,4,875
242,182,148,234,632,308,324,0,1,1,ABMrun_3.1.23_b,4,866
243,164,137,218,690,329,361,0,1,1,ABMrun_3.1.23_b,4,908
244,171,134,218,691,337,354,0,1,1,ABMrun_3.1.23_b,4,909
245,174,127,221,675,343,332,0,1,1,ABMrun_3.1.23_b,4,896
246,183,140,227,664,336,328,0,1,1,ABMrun_3.1.23_b,4,891
247,176,133,228,652,321,331,0,1,1,ABMrun_3.1.23_b,4,880
248,174,139,227,657,319,338,0,1,1,ABMrun_3.1.23_b,4,884
249,173,141,224,657,319,338,0,1,1,ABMrun_3.1.23_b,4,881
250,179,145,233,639,328,311,0,1,1,ABMrun_3.1.23_b,4,872
251,160,133,213,701,356,345,0,1,1,ABMrun_3.1.23_b,4,914
252,174,130,223,668,351,317,0,1,1,ABMrun_3.1.23_b,4,891
253,177,136,218,681,359,322,0,1,1,ABMrun_3.1.23_b,4,899
254,174,140,223,666,345,321,0,1,1,ABMrun_3.1.23_b,4,889
255,174,140,226,662,352,310,0,1,1,ABMrun_3.1.23_b,4,888
256,179,136,227,664,336,328,0,1,1,ABMrun_3.1.23_b,4,891
257,171,131,226,659,330,329,0,1,1,ABMrun_3.1.23_b,4,885
258,178,141,235,645,315,330,0,1,1,ABMrun_3.1.23_b,4,880
259,175,139,223,666,331,335,0,1,1,ABMrun_3.1.23_b,4,889
260,180,138,230,660,341,319,0,1,1,ABMrun_3.1.23_b,4,890
261,178,131,230,646,333,313,0,1,1,ABMrun_3.1.23_b,4,876
262,169,129,219,675,365,310,0,1,1,ABMrun_3.1.23_b,4,894
263,166,135,212,700,375,325,0,1,1,ABMrun_3.1.23_b,4,912
264,167,132,215,689,369,320,0,1,1,ABMrun_3.1.23_b,4,904
265,168,137,214,695,377,318,0,1,1,ABMrun_3.1.23_b,4,909
266,181,132,226,658,351,307,0,1,1,ABMrun_3.1.23_b,4,884
267,171,126,217,683,356,327,0,1,1,ABMrun_3.1.23_b,4,900
268,175,126,221,666,355,311,0,1,1,ABMrun_3.1.23_b,4,887
269,185,136,228,652,333,319,0,1,1,ABMrun_3.1.23_b,4,880
270,176,140,224,671,345,326,0,1,1,ABMrun_3.1.23_b,4,895
271,172,133,217,685,358,327,0,1,1,ABMrun_3.1.23_b,4,902
272,172,133,227,665,353,312,0,1,1,ABMrun_3.1.23_b,4,892
273,183,137,237,627,309,318,0,1,1,ABMrun_3.1.23_b,4,864
274,186,137,238,625,294,331,0,1,1,ABMrun_3.1.23_b,4,863
275,168,133,218,682,327,355,0,1,1,ABMrun_3.1.23_b,4,900
276,164,130,214,709,350,359,0,1,1,ABMrun_3.1.23_b,4,923
277,169,137,218,677,328,349,0,1,1,ABMrun_3.1.23_b,4,895
278,176,137,225,665,340,325,0,1,1,ABMrun_3.1.23_b,4,890
279,171,133,224,662,333,329,0,1,1,ABMrun_3.1.23_b,4,886
280,178,134,227,662,344,318,0,1,1,ABMrun_3.1.23_b,4,889
281,181,139,232,653,338,315,0,1,1,ABMrun_3.1.23_b,4,885
282,179,133,228,651,337,314,0,1,1,ABMrun_3.1.23_b,4,879
283,176,131,223,667,341,326,0,1,1,ABMrun_3.1.23_b,4,890
284,185,139,231,637,316,321,0,1,1,ABMrun_3.1.23_b,4,868
285,176,143,227,653,323,330,0,1,1,ABMrun_3.1.23_b,4,880
286,181,137,230,647,333,314,0,1,1,ABMrun_3.1.23_b,4,877
287,177,133,226,663,341,322,0,1,1,ABMrun_3.1.23_b,4,889
288,163,130,218,686,377,309,0,1,1,ABMrun_3.1.23_b,4,904
289,173,133,229,655,351,304,0,1,1,ABMrun_3.1.23_b,4,884
290,166,137,227,657,355,302,0,1,1,ABMrun_3.1.23_b,4,884
291,183,140,230,649,347,302,0,1,1,ABMrun_3.1.23_b,4,879
292,173,134,227,663,341,322,0,1,1,ABMrun_3.1.23_b,4,890
293,178,138,226,659,330,329,0,1,1,ABMrun_3.1.23_b,4,885
294,181,141,231,644,327,317,0,1,1,ABMrun_3.1.23_b,4,875
295,173,132,227,659,341,318,0,1,1,ABMrun_3.1.23_b,4,886
296,176,141,231,656,330,326,0,1,1,ABMrun_3.1.23_b,4,887
297,181,149,229,649,320,329,0,1,1,ABMrun_3.1.23_b,4,878
298,180,133,231,643,328,315,0,1,1,ABMrun_3.1.23_b,4,874
299,176,138,230,659,326,333,0,1,1,ABMrun_3.1.23_b,4,889
300,176,139,225,666,333,333,0,1,1,ABMrun_3.1.23_b,4,891
301,161,128,207,717,362,355,0,1,1,ABMrun_3.1.23_b,4,924
302,167,135,219,685,343,342,0,1,1,ABMrun_3.1.23_b,4,904
303,185,148,231,646,313,333,0,1,1,ABMrun_3.1.23_b,4,877
304,182,138,230,652,325,327,0,1,1,ABMrun_3.1.23_b,4,882
305,177,137,223,672,337,335,0,1,1,ABMrun_3.1.23_b,4,895
306,175,130,231,643,320,323,0,1,1,ABMrun_3.1.23_b,4,874
307,177,135,228,650,333,317,0,1,1,ABMrun_3.1.23_b,4,878
308,168,130,219,676,339,337,0,1,1,ABMrun_3.1.23_b,4,895
309,177,138,226,664,341,323,0,1,1,ABMrun_3.1.23_b,4,890
310,184,136,229,656,311,345,0,1,1,ABMrun_3.1.23_b,4,885
311,181,136,231,650,320,330,0,1,1,ABMrun_3.1.23_b,4,881
312,181,140,230,653,336,317,0,1,1,ABMrun_3.1.23_b,4,883
313,176,133,232,646,323,323,0,1,1,ABMrun_3.1.23_b,4,878
314,179,141,224,670,327,343,0,1,1,ABMrun_3.1.23_b,4,894
315,173,138,222,684,346,338,0,1,1,ABMrun_3.1.23_b,4,906
316,170,132,220,684,340,344,0,1,1,ABMrun_3.1.23_b,4,904
317,178,136,223,670,335,335,0,1,1,ABMrun_3.1.23_b,4,893
318,173,137,217,687,348,339,0,1,1,ABMrun_3.1.23_b,4,904
319,174,130,217,694,352,342,0,1,1,ABMrun_3.1.23_b,4,911
320,172,134,224,676,336,340,0,1,1,ABMrun_3.1.23_b,4,900
321,179,146,231,654,305,349,0,1,1,ABMrun_3.1.23_b,4,885
322,188,147,238,626,283,343,0,1,1,ABMrun_3.1.23_b,4,864
323,173,124,226,668,299,369,0,1,1,ABMrun_3.1.23_b,4,894
324,170,133,227,658,302,356,0,1,1,ABMrun_3.1.23_b,4,885
325,176,142,227,658,307,351,0,1,1,ABMrun_3.1.23_b,4,885
326,168,131,211,713,320,393,0,1,1,ABMrun_3.1.23_b,4,924
327,170,124,221,678,322,356,0,1,1,ABMrun_3.1.23_b,4,899
328,174,138,223,665,312,353,0,1,1,ABMrun_3.1.23_b,4,888
329,176,136,225,668,320,348,0,1,1,ABMrun_3.1.23_b,4,893
330,177,135,230,655,315,340,0,1,1,ABMrun_3.1.23_b,4,885
331,173,140,227,666,327,339,0,1,1,ABMrun_3.1.23_b,4,893
332,172,134,222,678,349,329,0,1,1,ABMrun_3.1.23_b,4,900
333,168,133,214,692,348,344,0,1,1,ABMrun_3.1.23_b,4,906
334,159,127,213,698,333,365,0,1,1,ABMrun_3.1.23_b,4,911
335,167,128,216,696,341,355,0,1,1,ABMrun_3.1.23_b,4,912
336,178,140,228,653,318,335,0,1,1,ABMrun_3.1.23_b,4,881
337,176,140,227,659,338,321,0,1,1,ABMrun_3.1.23_b,4,886
338,174,136,219,673,336,337,0,1,1,ABMrun_3.1.23_b,4,892
339,168,135,219,686,354,332,0,1,1,ABMrun_3.1.23_b,4,905
340,182,138,227,659,313,346,0,1,1,ABMrun_3.1.23_b,4,886
341,177,135,230,657,309,348,0,1,1,ABMrun_3.1.23_b,4,887
342,174,137,227,664,330,334,0,1,1,ABMrun_3.1.23_b,4,891
343,181,138,229,663,312,351,0,1,1,ABMrun_3.1.23_b,4,892
344,170,131,225,665,327,338,0,1,1,ABMrun_3.1.23_b,4,890
345,167,133,221,674,336,338,0,1,1,ABMrun_3.1.23_b,4,895
346,160,121,216,687,355,332,0,1,1,ABMrun_3.1.23_b,4,903
347,180,131,224,671,336,335,0,1,1,ABMrun_3.1.23_b,4,895
348,179,138,232,640,324,316,0,1,1,ABMrun_3.1.23_b,4,872
349,183,142,231,636,310,326,0,1,1,ABMrun_3.1.23_b,4,867
350,174,135,225,668,323,345,0,1,1,ABMrun_3.1.23_b,4,893
1,10,10,12,628,301,327,0,2,1,ABMrun_3.1.23_b,4,640
2,88,84,108,878,430,448,0,2,1,ABMrun_3.1.23_b,4,986
3,126,102,172,786,397,389,0,2,1,ABMrun_3.1.23_b,4,958
4,174,134,220,691,343,348,0,2,1,ABMrun_3.1.23_b,4,911
5,182,144,227,667,332,335,0,2,1,ABMrun_3.1.23_b,4,894
6,182,126,241,610,301,309,0,2,1,ABMrun_3.1.23_b,4,851
7,176,136,231,653,313,340,0,2,1,ABMrun_3.1.23_b,4,884
8,175,125,228,657,323,334,0,2,1,ABMrun_3.1.23_b,4,885
9,182,136,232,656,313,343,0,2,1,ABMrun_3.1.23_b,4,888
10,185,136,233,642,309,333,0,2,1,ABMrun_3.1.23_b,4,875
11,186,132,232,650,327,323,0,2,1,ABMrun_3.1.23_b,4,882
12,171,133,227,660,342,318,0,2,1,ABMrun_3.1.23_b,4,887
13,192,147,240,618,320,298,0,2,1,ABMrun_3.1.23_b,4,858
14,175,135,228,659,352,307,0,2,1,ABMrun_3.1.23_b,4,887
15,173,134,229,661,366,295,0,2,1,ABMrun_3.1.23_b,4,890
16,176,128,227,657,345,312,0,2,1,ABMrun_3.1.23_b,4,884
17,180,134,231,654,337,317,0,2,1,ABMrun_3.1.23_b,4,885
18,178,133,224,669,344,325,0,2,1,ABMrun_3.1.23_b,4,893
19,183,131,233,646,319,327,0,2,1,ABMrun_3.1.23_b,4,879
20,182,134,237,638,321,317,0,2,1,ABMrun_3.1.23_b,4,875
21,185,144,232,659,332,327,0,2,1,ABMrun_3.1.23_b,4,891
22,181,138,235,645,329,316,0,2,1,ABMrun_3.1.23_b,4,880
23,183,133,231,648,322,326,0,2,1,ABMrun_3.1.23_b,4,879
24,180,142,232,657,328,329,0,2,1,ABMrun_3.1.23_b,4,889
25,169,131,225,670,349,321,0,2,1,ABMrun_3.1.23_b,4,895
26,167,124,217,709,373,336,0,2,1,ABMrun_3.1.23_b,4,926
27,178,133,230,668,333,335,0,2,1,ABMrun_3.1.23_b,4,898
28,178,130,230,659,331,328,0,2,1,ABMrun_3.1.23_b,4,889
29,169,132,226,663,335,328,0,2,1,ABMrun_3.1.23_b,4,889
30,180,136,231,646,316,330,0,2,1,ABMrun_3.1.23_b,4,877
31,183,142,232,653,323,330,0,2,1,ABMrun_3.1.23_b,4,885
32,189,152,238,623,305,318,0,2,1,ABMrun_3.1.23_b,4,861
33,167,127,219,680,348,332,0,2,1,ABMrun_3.1.23_b,4,899
34,171,131,217,684,339,345,0,2,1,ABMrun_3.1.23_b,4,901
35,181,135,233,650,317,333,0,2,1,ABMrun_3.1.23_b,4,883
36,174,136,229,663,328,335,0,2,1,ABMrun_3.1.23_b,4,892
37,181,138,232,660,342,318,0,2,1,ABMrun_3.1.23_b,4,892
38,188,127,241,626,313,313,0,2,1,ABMrun_3.1.23_b,4,867
39,182,134,237,635,311,324,0,2,1,ABMrun_3.1.23_b,4,872
40,185,137,237,636,303,333,0,2,1,ABMrun_3.1.23_b,4,873
41,181,142,239,636,316,320,0,2,1,ABMrun_3.1.23_b,4,875
42,175,135,229,665,332,333,0,2,1,ABMrun_3.1.23_b,4,894
43,188,139,235,640,323,317,0,2,1,ABMrun_3.1.23_b,4,875
44,176,140,229,661,335,326,0,2,1,ABMrun_3.1.23_b,4,890
45,183,138,239,622,303,319,0,2,1,ABMrun_3.1.23_b,4,861
46,176,138,226,658,314,344,0,2,1,ABMrun_3.1.23_b,4,884
47,181,139,229,662,315,347,0,2,1,ABMrun_3.1.23_b,4,891
48,183,137,234,642,311,331,0,2,1,ABMrun_3.1.23_b,4,876
49,188,134,237,627,312,315,0,2,1,ABMrun_3.1.23_b,4,864
50,191,138,236,635,334,301,0,2,1,ABMrun_3.1.23_b,4,871
51,171,139,207,717,358,359,0,2,1,ABMrun_3.1.23_b,4,924
52,181,136,230,659,332,327,0,2,1,ABMrun_3.1.23_b,4,889
53,184,135,233,641,309,332,0,2,1,ABMrun_3.1.23_b,4,874
54,185,139,233,648,314,334,0,2,1,ABMrun_3.1.23_b,4,881
55,172,132,223,678,341,337,0,2,1,ABMrun_3.1.23_b,4,901
56,172,139,221,687,352,335,0,2,1,ABMrun_3.1.23_b,4,908
57,167,131,222,674,343,331,0,2,1,ABMrun_3.1.23_b,4,896
58,187,145,238,623,299,324,0,2,1,ABMrun_3.1.23_b,4,861
59,181,137,234,651,337,314,0,2,1,ABMrun_3.1.23_b,4,885
60,176,140,231,665,347,318,0,2,1,ABMrun_3.1.23_b,4,896
61,177,130,229,657,341,316,0,2,1,ABMrun_3.1.23_b,4,886
62,177,137,231,661,352,309,0,2,1,ABMrun_3.1.23_b,4,892
63,176,137,228,662,352,310,0,2,1,ABMrun_3.1.23_b,4,890
64,180,138,231,652,328,324,0,2,1,ABMrun_3.1.23_b,4,883
65,177,139,229,652,331,321,0,2,1,ABMrun_3.1.23_b,4,881
66,188,146,234,652,318,334,0,2,1,ABMrun_3.1.23_b,4,886
67,182,135,235,637,320,317,0,2,1,ABMrun_3.1.23_b,4,872
68,183,146,231,658,326,332,0,2,1,ABMrun_3.1.23_b,4,889
69,183,135,231,651,318,333,0,2,1,ABMrun_3.1.23_b,4,882
70,182,140,226,670,333,337,0,2,1,ABMrun_3.1.23_b,4,896
71,183,144,231,648,320,328,0,2,1,ABMrun_3.1.23_b,4,879
72,168,133,222,686,333,353,0,2,1,ABMrun_3.1.23_b,4,908
73,179,141,225,670,309,361,0,2,1,ABMrun_3.1.23_b,4,895
74,174,134,225,677,330,347,0,2,1,ABMrun_3.1.23_b,4,902
75,172,133,225,671,333,338,0,2,1,ABMrun_3.1.23_b,4,896
76,167,129,215,716,363,353,0,2,1,ABMrun_3.1.23_b,4,931
77,181,139,230,657,339,318,0,2,1,ABMrun_3.1.23_b,4,887
78,179,134,229,661,354,307,0,2,1,ABMrun_3.1.23_b,4,890
79,182,125,229,652,353,299,0,2,1,ABMrun_3.1.23_b,4,881
80,178,141,228,662,332,330,0,2,1,ABMrun_3.1.23_b,4,890
81,182,140,231,655,309,346,0,2,1,ABMrun_3.1.23_b,4,886
82,173,135,225,667,319,348,0,2,1,ABMrun_3.1.23_b,4,892
83,165,137,217,690,334,356,0,2,1,ABMrun_3.1.23_b,4,907
84,175,139,225,673,339,334,0,2,1,ABMrun_3.1.23_b,4,898
85,169,133,220,680,358,322,0,2,1,ABMrun_3.1.23_b,4,900
86,175,132,226,664,336,328,0,2,1,ABMrun_3.1.23_b,4,890
87,184,138,232,645,320,325,0,2,1,ABMrun_3.1.23_b,4,877
88,176,135,231,647,328,319,0,2,1,ABMrun_3.1.23_b,4,878
89,177,135,229,655,319,336,0,2,1,ABMrun_3.1.23_b,4,884
90,172,126,227,664,328,336,0,2,1,ABMrun_3.1.23_b,4,891
91,184,143,226,663,313,350,0,2,1,ABMrun_3.1.23_b,4,889
92,173,140,224,671,315,356,0,2,1,ABMrun_3.1.23_b,4,895
93,169,139,216,691,329,362,0,2,1,ABMrun_3.1.23_b,4,907
94,179,133,228,661,339,322,0,2,1,ABMrun_3.1.23_b,4,889
95,183,137,236,636,326,310,0,2,1,ABMrun_3.1.23_b,4,872
96,181,135,227,661,319,342,0,2,1,ABMrun_3.1.23_b,4,888
97,171,136,223,686,332,354,0,2,1,ABMrun_3.1.23_b,4,909
98,168,138,215,696,333,363,0,2,1,ABMrun_3.1.23_b,4,911
99,181,135,225,668,319,349,0,2,1,ABMrun_3.1.23_b,4,893
100,174,131,220,651,315,336,0,2,1,ABMrun_3.1.23_b,4,871
101,144,113,188,703,363,340,0,2,1,ABMrun_3.1.23_b,4,891
102,153,118,207,608,315,293,0,2,1,ABMrun_3.1.23_b,4,815
103,161,127,203,568,290,278,0,2,1,ABMrun_3.1.23_b,4,771
104,151,120,190,581,298,283,0,2,1,ABMrun_3.1.23_b,4,771
105,139,107,174,577,296,281,0,2,1,ABMrun_3.1.23_b,4,751
106,135,110,168,547,278,269,0,2,1,ABMrun_3.1.23_b,4,715
107,136,103,174,496,244,252,0,2,1,ABMrun_3.1.23_b,4,670
108,131,94,169,473,235,238,0,2,1,ABMrun_3.1.23_b,4,642
109,116,92,144,501,243,258,0,2,1,ABMrun_3.1.23_b,4,645
110,61,55,81,464,231,233,0,2,1,ABMrun_3.1.23_b,4,545
111,69,55,86,394,194,200,0,2,1,ABMrun_3.1.23_b,4,480
112,64,55,86,327,164,163,0,2,1,ABMrun_3.1.23_b,4,413
113,60,46,81,270,131,139,0,2,1,ABMrun_3.1.23_b,4,351
114,60,49,78,246,110,136,0,2,1,ABMrun_3.1.23_b,4,324
115,59,51,78,237,104,133,0,2,1,ABMrun_3.1.23_b,4,315
116,60,49,76,227,91,136,0,2,1,ABMrun_3.1.23_b,4,303
117,53,45,75,231,100,131,0,2,1,ABMrun_3.1.23_b,4,306
118,59,47,77,230,98,132,0,2,1,ABMrun_3.1.23_b,4,307
119,61,52,75,229,98,131,0,2,1,ABMrun_3.1.23_b,4,304
120,60,45,77,227,111,116,0,2,1,ABMrun_3.1.23_b,4,304
121,61,46,75,229,121,108,0,2,1,ABMrun_3.1.23_b,4,304
122,58,45,73,218,117,101,0,2,1,ABMrun_3.1.23_b,4,291
123,54,39,71,206,113,93,0,2,1,ABMrun_3.1.23_b,4,277
124,55,37,73,200,107,93,0,2,1,ABMrun_3.1.23_b,4,273
125,57,46,73,213,117,96,0,2,1,ABMrun_3.1.23_b,4,286
126,62,45,75,226,125,101,0,2,1,ABMrun_3.1.23_b,4,301
127,59,45,72,208,113,95,0,2,1,ABMrun_3.1.23_b,4,280
128,61,48,75,211,97,114,0,2,1,ABMrun_3.1.23_b,4,286
129,58,48,74,216,97,119,0,2,1,ABMrun_3.1.23_b,4,290
130,57,47,73,215,91,124,0,2,1,ABMrun_3.1.23_b,4,288
131,57,50,71,197,91,106,0,2,1,ABMrun_3.1.23_b,4,268
132,56,41,71,200,97,103,0,2,1,ABMrun_3.1.23_b,4,271
133,54,45,71,204,100,104,0,2,1,ABMrun_3.1.23_b,4,275
134,58,47,71,208,106,102,0,2,1,ABMrun_3.1.23_b,4,279
135,55,41,75,213,98,115,0,2,1,ABMrun_3.1.23_b,4,288
136,53,39,71,200,91,109,0,2,1,ABMrun_3.1.23_b,4,271
137,55,40,71,202,99,103,0,2,1,ABMrun_3.1.23_b,4,273
138,52,44,67,188,99,89,0,2,1,ABMrun_3.1.23_b,4,255
139,53,40,65,181,97,84,0,2,1,ABMrun_3.1.23_b,4,246
140,53,38,68,187,102,85,0,2,1,ABMrun_3.1.23_b,4,255
141,53,32,66,184,103,81,0,2,1,ABMrun_3.1.23_b,4,250
142,53,39,68,190,104,86,0,2,1,ABMrun_3.1.23_b,4,258
143,56,44,72,207,111,96,0,2,1,ABMrun_3.1.23_b,4,279
144,60,43,74,212,117,95,0,2,1,ABMrun_3.1.23_b,4,286
145,55,43,71,206,107,99,0,2,1,ABMrun_3.1.23_b,4,277
146,54,41,72,212,108,104,0,2,1,ABMrun_3.1.23_b,4,284
147,57,47,76,227,116,111,0,2,1,ABMrun_3.1.23_b,4,303
148,58,44,74,216,114,102,0,2,1,ABMrun_3.1.23_b,4,290
149,60,49,75,211,99,112,0,2,1,ABMrun_3.1.23_b,4,286
150,55,41,74,218,107,111,0,2,1,ABMrun_3.1.23_b,4,292
151,107,71,163,252,113,139,15,2,1,ABMrun_3.1.23_b,4,415
152,128,84,182,312,140,172,12,2,1,ABMrun_3.1.23_b,4,494
153,148,110,198,418,192,226,6,2,1,ABMrun_3.1.23_b,4,616
154,164,120,199,485,234,251,2,2,1,ABMrun_3.1.23_b,4,684
155,158,118,204,523,245,278,0,2,1,ABMrun_3.1.23_b,4,727
156,162,130,210,551,248,303,1,2,1,ABMrun_3.1.23_b,4,761
157,160,122,208,586,270,316,0,2,1,ABMrun_3.1.23_b,4,794
158,166,122,218,597,282,315,0,2,1,ABMrun_3.1.23_b,4,815
159,170,133,226,617,287,330,0,2,1,ABMrun_3.1.23_b,4,843
160,185,139,235,634,312,322,0,2,1,ABMrun_3.1.23_b,4,869
161,177,144,228,667,346,321,0,2,1,ABMrun_3.1.23_b,4,895
162,164,135,218,694,366,328,0,2,1,ABMrun_3.1.23_b,4,912
163,169,136,220,687,356,331,0,2,1,ABMrun_3.1.23_b,4,907
164,176,134,229,658,329,329,0,2,1,ABMrun_3.1.23_b,4,887
165,170,134,218,687,339,348,16,2,1,ABMrun_3.1.23_b,4,905
166,186,151,237,636,310,326,7,2,1,ABMrun_3.1.23_b,4,873
167,184,144,237,632,303,329,3,2,1,ABMrun_3.1.23_b,4,869
168,181,141,234,634,307,327,0,2,1,ABMrun_3.1.23_b,4,868
169,177,136,232,644,305,339,0,2,1,ABMrun_3.1.23_b,4,876
170,171,130,218,688,315,373,0,2,1,ABMrun_3.1.23_b,4,906
171,168,131,225,670,321,349,0,2,1,ABMrun_3.1.23_b,4,895
172,169,129,220,679,342,337,0,2,1,ABMrun_3.1.23_b,4,899
173,171,136,222,676,342,334,0,2,1,ABMrun_3.1.23_b,4,898
174,170,124,219,683,347,336,0,2,1,ABMrun_3.1.23_b,4,902
175,177,149,224,675,343,332,0,2,1,ABMrun_3.1.23_b,4,899
176,165,137,216,698,350,348,0,2,1,ABMrun_3.1.23_b,4,914
177,177,147,229,655,334,321,0,2,1,ABMrun_3.1.23_b,4,884
178,179,135,229,651,334,317,0,2,1,ABMrun_3.1.23_b,4,880
179,169,130,226,671,356,315,0,2,1,ABMrun_3.1.23_b,4,897
180,176,128,226,667,356,311,0,2,1,ABMrun_3.1.23_b,4,893
181,172,132,216,686,354,332,10,2,1,ABMrun_3.1.23_b,4,902
182,184,144,226,665,312,353,9,2,1,ABMrun_3.1.23_b,4,891
183,167,126,214,696,340,356,5,2,1,ABMrun_3.1.23_b,4,910
184,177,132,226,665,339,326,5,2,1,ABMrun_3.1.23_b,4,891
185,173,136,232,638,332,306,2,2,1,ABMrun_3.1.23_b,4,870
186,185,137,236,628,319,309,1,2,1,ABMrun_3.1.23_b,4,864
187,182,140,220,685,346,339,0,2,1,ABMrun_3.1.23_b,4,905
188,166,119,220,674,344,330,0,2,1,ABMrun_3.1.23_b,4,894
189,173,132,215,696,360,336,0,2,1,ABMrun_3.1.23_b,4,911
190,176,136,223,667,348,319,0,2,1,ABMrun_3.1.23_b,4,890
191,180,141,223,672,351,321,0,2,1,ABMrun_3.1.23_b,4,895
192,177,140,225,672,335,337,0,2,1,ABMrun_3.1.23_b,4,897
193,173,139,226,668,351,317,0,2,1,ABMrun_3.1.23_b,4,894
194,181,135,233,644,325,319,0,2,1,ABMrun_3.1.23_b,4,877
195,173,132,219,677,338,339,13,2,1,ABMrun_3.1.23_b,4,896
196,176,133,224,670,329,341,6,2,1,ABMrun_3.1.23_b,4,894
197,167,133,222,676,331,345,3,2,1,ABMrun_3.1.23_b,4,898
198,170,138,220,675,321,354,1,2,1,ABMrun_3.1.23_b,4,895
199,177,145,225,671,319,352,0,2,1,ABMrun_3.1.23_b,4,896
200,181,148,233,642,304,338,0,2,1,ABMrun_3.1.23_b,4,875
201,177,144,226,665,311,354,0,2,1,ABMrun_3.1.23_b,4,891
202,171,127,227,657,309,348,0,2,1,ABMrun_3.1.23_b,4,884
203,183,135,229,646,301,345,0,2,1,ABMrun_3.1.23_b,4,875
204,176,143,226,668,316,352,0,2,1,ABMrun_3.1.23_b,4,894
205,182,141,226,672,332,340,0,2,1,ABMrun_3.1.23_b,4,898
206,174,135,228,665,329,336,0,2,1,ABMrun_3.1.23_b,4,893
207,176,139,225,665,317,348,0,2,1,ABMrun_3.1.23_b,4,890
208,182,133,224,673,314,359,0,2,1,ABMrun_3.1.23_b,4,897
209,177,140,222,670,330,340,0,2,1,ABMrun_3.1.23_b,4,892
210,171,131,218,681,350,331,0,2,1,ABMrun_3.1.23_b,4,899
211,182,139,226,668,344,324,0,2,1,ABMrun_3.1.23_b,4,894
212,174,139,223,670,345,325,0,2,1,ABMrun_3.1.23_b,4,893
213,173,132,227,649,329,320,0,2,1,ABMrun_3.1.23_b,4,876
214,176,130,228,670,342,328,0,2,1,ABMrun_3.1.23_b,4,898
215,174,136,226,660,339,321,0,2,1,ABMrun_3.1.23_b,4,886
216,174,142,222,673,346,327,0,2,1,ABMrun_3.1.23_b,4,895
217,175,137,224,671,348,323,0,2,1,ABMrun_3.1.23_b,4,895
218,176,141,228,665,344,321,0,2,1,ABMrun_3.1.23_b,4,893
219,173,135,219,680,322,358,0,2,1,ABMrun_3.1.23_b,4,899
220,168,128,219,677,322,355,0,2,1,ABMrun_3.1.23_b,4,896
221,176,136,226,665,314,351,0,2,1,ABMrun_3.1.23_b,4,891
222,169,134,222,673,334,339,0,2,1,ABMrun_3.1.23_b,4,895
223,170,133,231,648,322,326,0,2,1,ABMrun_3.1.23_b,4,879
224,175,136,222,677,340,337,0,2,1,ABMrun_3.1.23_b,4,899
225,170,124,225,664,347,317,0,2,1,ABMrun_3.1.23_b,4,889
226,159,124,203,723,378,345,0,2,1,ABMrun_3.1.23_b,4,926
227,174,141,221,671,332,339,0,2,1,ABMrun_3.1.23_b,4,892
228,173,142,224,668,324,344,0,2,1,ABMrun_3.1.23_b,4,892
229,171,139,224,667,319,348,0,2,1,ABMrun_3.1.23_b,4,891
230,169,144,220,684,318,366,0,2,1,ABMrun_3.1.23_b,4,904
231,168,127,228,653,320,333,0,2,1,ABMrun_3.1.23_b,4,881
232,171,137,217,683,340,343,0,2,1,ABMrun_3.1.23_b,4,900
233,171,131,224,667,317,350,0,2,1,ABMrun_3.1.23_b,4,891
234,175,132,228,649,327,322,0,2,1,ABMrun_3.1.23_b,4,877
235,175,137,230,644,314,330,0,2,1,ABMrun_3.1.23_b,4,874
236,180,136,228,655,325,330,0,2,1,ABMrun_3.1.23_b,4,883
237,170,127,227,662,328,334,0,2,1,ABMrun_3.1.23_b,4,889
238,169,136,218,679,335,344,0,2,1,ABMrun_3.1.23_b,4,897
239,175,125,231,652,313,339,0,2,1,ABMrun_3.1.23_b,4,883
240,170,133,218,687,336,351,0,2,1,ABMrun_3.1.23_b,4,905
241,172,131,225,661,331,330,0,2,1,ABMrun_3.1.23_b,4,886
242,167,135,218,688,346,342,0,2,1,ABMrun_3.1.23_b,4,906
243,175,146,226,665,325,340,0,2,1,ABMrun_3.1.23_b,4,891
244,183,139,228,654,328,326,0,2,1,ABMrun_3.1.23_b,4,882
245,168,135,216,694,341,353,0,2,1,ABMrun_3.1.23_b,4,910
246,181,148,228,652,323,329,0,2,1,ABMrun_3.1.23_b,4,880
247,172,143,226,666,324,342,0,2,1,ABMrun_3.1.23_b,4,892
248,175,134,227,659,312,347,0,2,1,ABMrun_3.1.23_b,4,886
249,181,147,225,669,341,328,0,2,1,ABMrun_3.1.23_b,4,894
250,179,138,226,666,346,320,0,2,1,ABMrun_3.1.23_b,4,892
251,156,132,199,730,371,359,0,2,1,ABMrun_3.1.23_b,4,929
252,181,136,231,654,323,331,0,2,1,ABMrun_3.1.23_b,4,885
253,183,141,227,666,325,341,0,2,1,ABMrun_3.1.23_b,4,893
254,174,144,227,657,319,338,0,2,1,ABMrun_3.1.23_b,4,884
255,180,133,225,666,322,344,0,2,1,ABMrun_3.1.23_b,4,891
256,179,137,228,654,307,347,0,2,1,ABMrun_3.1.23_b,4,882
257,175,152,221,683,307,376,0,2,1,ABMrun_3.1.23_b,4,904
258,176,145,218,682,323,359,0,2,1,ABMrun_3.1.23_b,4,900
259,182,142,224,670,333,337,0,2,1,ABMrun_3.1.23_b,4,894
260,168,134,222,682,341,341,0,2,1,ABMrun_3.1.23_b,4,904
261,178,132,225,661,344,317,0,2,1,ABMrun_3.1.23_b,4,886
262,174,137,227,664,341,323,0,2,1,ABMrun_3.1.23_b,4,891
263,184,135,227,658,332,326,0,2,1,ABMrun_3.1.23_b,4,885
264,170,136,224,667,315,352,0,2,1,ABMrun_3.1.23_b,4,891
265,173,132,228,655,310,345,0,2,1,ABMrun_3.1.23_b,4,883
266,174,143,231,650,311,339,0,2,1,ABMrun_3.1.23_b,4,881
267,176,141,231,643,305,338,0,2,1,ABMrun_3.1.23_b,4,874
268,178,142,226,660,331,329,0,2,1,ABMrun_3.1.23_b,4,886
269,175,141,229,665,339,326,0,2,1,ABMrun_3.1.23_b,4,894
270,163,121,220,680,356,324,0,2,1,ABMrun_3.1.23_b,4,900
271,171,135,219,682,357,325,0,2,1,ABMrun_3.1.23_b,4,901
272,183,136,228,655,332,323,0,2,1,ABMrun_3.1.23_b,4,883
273,178,131,225,672,345,327,0,2,1,ABMrun_3.1.23_b,4,897
274,181,138,235,624,308,316,0,2,1,ABMrun_3.1.23_b,4,859
275,176,130,226,655,332,323,0,2,1,ABMrun_3.1.23_b,4,881
276,158,122,209,706,370,336,0,2,1,ABMrun_3.1.23_b,4,915
277,174,135,224,666,353,313,0,2,1,ABMrun_3.1.23_b,4,890
278,178,140,223,675,353,322,0,2,1,ABMrun_3.1.23_b,4,898
279,183,139,233,640,325,315,0,2,1,ABMrun_3.1.23_b,4,873
280,172,130,221,680,350,330,0,2,1,ABMrun_3.1.23_b,4,901
281,174,140,226,663,324,339,0,2,1,ABMrun_3.1.23_b,4,889
282,173,135,221,678,337,341,0,2,1,ABMrun_3.1.23_b,4,899
283,176,136,221,678,336,342,0,2,1,ABMrun_3.1.23_b,4,899
284,170,135,220,672,333,339,0,2,1,ABMrun_3.1.23_b,4,892
285,177,140,230,652,334,318,0,2,1,ABMrun_3.1.23_b,4,882
286,175,126,226,673,340,333,0,2,1,ABMrun_3.1.23_b,4,899
287,177,135,227,668,340,328,0,2,1,ABMrun_3.1.23_b,4,895
288,176,143,229,652,322,330,0,2,1,ABMrun_3.1.23_b,4,881
289,174,134,229,653,315,338,0,2,1,ABMrun_3.1.23_b,4,882
290,175,144,218,681,331,350,0,2,1,ABMrun_3.1.23_b,4,899
291,175,136,224,665,322,343,0,2,1,ABMrun_3.1.23_b,4,889
292,174,137,222,675,333,342,0,2,1,ABMrun_3.1.23_b,4,897
293,172,132,221,688,352,336,0,2,1,ABMrun_3.1.23_b,4,909
294,176,136,222,677,359,318,0,2,1,ABMrun_3.1.23_b,4,899
295,177,140,219,684,362,322,0,2,1,ABMrun_3.1.23_b,4,903
296,182,127,230,659,336,323,0,2,1,ABMrun_3.1.23_b,4,889
297,177,139,220,684,351,333,0,2,1,ABMrun_3.1.23_b,4,904
298,174,130,223,675,353,322,0,2,1,ABMrun_3.1.23_b,4,898
299,171,135,226,664,345,319,0,2,1,ABMrun_3.1.23_b,4,890
300,177,132,227,657,343,314,0,2,1,ABMrun_3.1.23_b,4,884
301,169,132,213,707,365,342,0,2,1,ABMrun_3.1.23_b,4,920
302,160,130,205,715,372,343,0,2,1,ABMrun_3.1.23_b,4,920
303,184,133,226,664,334,330,0,2,1,ABMrun_3.1.23_b,4,890
304,169,131,222,677,335,342,0,2,1,ABMrun_3.1.23_b,4,899
305,177,133,223,675,342,333,0,2,1,ABMrun_3.1.23_b,4,898
306,173,135,224,670,339,331,0,2,1,ABMrun_3.1.23_b,4,894
307,176,135,227,652,310,342,0,2,1,ABMrun_3.1.23_b,4,879
308,182,134,225,666,329,337,0,2,1,ABMrun_3.1.23_b,4,891
309,173,128,221,680,331,349,0,2,1,ABMrun_3.1.23_b,4,901
310,174,135,222,666,323,343,0,2,1,ABMrun_3.1.23_b,4,888
311,173,143,223,670,327,343,0,2,1,ABMrun_3.1.23_b,4,893
312,182,142,230,649,311,338,0,2,1,ABMrun_3.1.23_b,4,879
313,174,137,224,670,318,352,0,2,1,ABMrun_3.1.23_b,4,894
314,172,133,220,673,325,348,0,2,1,ABMrun_3.1.23_b,4,893
315,176,137,225,667,318,349,0,2,1,ABMrun_3.1.23_b,4,892
316,176,136,225,669,323,346,0,2,1,ABMrun_3.1.23_b,4,894
317,180,138,226,653,304,349,0,2,1,ABMrun_3.1.23_b,4,879
318,178,145,232,638,295,343,0,2,1,ABMrun_3.1.23_b,4,870
319,168,133,222,672,316,356,0,2,1,ABMrun_3.1.23_b,4,894
320,172,138,215,685,329,356,0,2,1,ABMrun_3.1.23_b,4,900
321,169,129,227,663,310,353,0,2,1,ABMrun_3.1.23_b,4,890
322,181,136,231,635,297,338,0,2,1,ABMrun_3.1.23_b,4,866
323,179,136,229,659,308,351,0,2,1,ABMrun_3.1.23_b,4,888
324,170,136,217,684,319,365,0,2,1,ABMrun_3.1.23_b,4,901
325,169,134,215,692,342,350,0,2,1,ABMrun_3.1.23_b,4,907
326,158,127,199,733,369,364,0,2,1,ABMrun_3.1.23_b,4,932
327,168,134,221,671,328,343,0,2,1,ABMrun_3.1.23_b,4,892
328,180,142,234,626,306,320,0,2,1,ABMrun_3.1.23_b,4,860
329,177,136,228,658,311,347,0,2,1,ABMrun_3.1.23_b,4,886
330,180,143,233,643,307,336,0,2,1,ABMrun_3.1.23_b,4,876
331,169,132,224,671,309,362,0,2,1,ABMrun_3.1.23_b,4,895
332,176,137,232,648,305,343,0,2,1,ABMrun_3.1.23_b,4,880
333,177,137,232,645,304,341,0,2,1,ABMrun_3.1.23_b,4,877
334,180,145,229,658,314,344,0,2,1,ABMrun_3.1.23_b,4,887
335,174,135,223,670,326,344,0,2,1,ABMrun_3.1.23_b,4,893
336,187,141,228,659,327,332,0,2,1,ABMrun_3.1.23_b,4,887
337,172,134,224,674,348,326,0,2,1,ABMrun_3.1.23_b,4,898
338,177,140,225,670,330,340,0,2,1,ABMrun_3.1.23_b,4,895
339,175,130,230,654,327,327,0,2,1,ABMrun_3.1.23_b,4,884
340,179,123,228,654,329,325,0,2,1,ABMrun_3.1.23_b,4,882
341,178,137,226,655,323,332,0,2,1,ABMrun_3.1.23_b,4,881
342,174,126,222,670,345,325,0,2,1,ABMrun_3.1.23_b,4,892
343,177,128,227,656,347,309,0,2,1,ABMrun_3.1.23_b,4,883
344,183,136,233,640,334,306,0,2,1,ABMrun_3.1.23_b,4,873
345,177,140,226,665,330,335,0,2,1,ABMrun_3.1.23_b,4,891
346,172,129,224,669,328,341,0,2,1,ABMrun_3.1.23_b,4,893
347,168,142,216,690,330,360,0,2,1,ABMrun_3.1.23_b,4,906
348,176,136,228,656,298,358,0,2,1,ABMrun_3.1.23_b,4,884
349,185,137,231,648,300,348,0,2,1,ABMrun_3.1.23_b,4,879
350,179,137,224,672,316,356,0,2,1,ABMrun_3.1.23_b,4,896
1,16,16,22,613,302,311,0,3,1,ABMrun_3.1.23_b,4,635
2,87,78,117,865,438,427,0,3,1,ABMrun_3.1.23_b,4,982
3,135,118,174,782,385,397,0,3,1,ABMrun_3.1.23_b,4,956
4,158,124,198,733,366,367,0,3,1,ABMrun_3.1.23_b,4,931
5,189,145,236,633,330,303,0,3,1,ABMrun_3.1.23_b,4,869
6,183,142,239,620,314,306,0,3,1,ABMrun_3.1.23_b,4,859
7,186,152,240,620,312,308,0,3,1,ABMrun_3.1.23_b,4,860
8,179,131,233,649,340,309,0,3,1,ABMrun_3.1.23_b,4,882
9,177,132,229,650,326,324,0,3,1,ABMrun_3.1.23_b,4,879
10,184,133,237,625,321,304,0,3,1,ABMrun_3.1.23_b,4,862
11,177,133,231,651,326,325,0,3,1,ABMrun_3.1.23_b,4,882
12,182,144,234,646,311,335,0,3,1,ABMrun_3.1.23_b,4,880
13,182,139,235,629,298,331,0,3,1,ABMrun_3.1.23_b,4,864
14,178,137,237,632,300,332,0,3,1,ABMrun_3.1.23_b,4,869
15,183,143,233,640,306,334,0,3,1,ABMrun_3.1.23_b,4,873
16,179,141,232,648,308,340,0,3,1,ABMrun_3.1.23_b,4,880
17,176,131,236,641,314,327,0,3,1,ABMrun_3.1.23_b,4,877
18,174,131,223,677,334,343,0,3,1,ABMrun_3.1.23_b,4,900
19,178,141,226,671,352,319,0,3,1,ABMrun_3.1.23_b,4,897
20,178,136,225,666,360,306,0,3,1,ABMrun_3.1.23_b,4,891
21,171,130,227,658,344,314,0,3,1,ABMrun_3.1.23_b,4,885
22,181,130,235,646,340,306,0,3,1,ABMrun_3.1.23_b,4,881
23,174,134,232,653,347,306,0,3,1,ABMrun_3.1.23_b,4,885
24,175,134,231,660,335,325,0,3,1,ABMrun_3.1.23_b,4,891
25,180,136,234,651,313,338,0,3,1,ABMrun_3.1.23_b,4,885
26,158,126,205,726,354,372,0,3,1,ABMrun_3.1.23_b,4,931
27,178,138,231,661,327,334,0,3,1,ABMrun_3.1.23_b,4,892
28,180,137,235,635,318,317,0,3,1,ABMrun_3.1.23_b,4,870
29,178,139,227,660,313,347,0,3,1,ABMrun_3.1.23_b,4,887
30,178,134,230,652,295,357,0,3,1,ABMrun_3.1.23_b,4,882
31,184,142,235,646,311,335,0,3,1,ABMrun_3.1.23_b,4,881
32,180,139,228,664,310,354,0,3,1,ABMrun_3.1.23_b,4,892
33,173,132,227,674,327,347,0,3,1,ABMrun_3.1.23_b,4,901
34,179,137,234,637,295,342,0,3,1,ABMrun_3.1.23_b,4,871
35,176,138,227,676,304,372,0,3,1,ABMrun_3.1.23_b,4,903
36,181,144,229,663,308,355,0,3,1,ABMrun_3.1.23_b,4,892
37,184,138,231,654,320,334,0,3,1,ABMrun_3.1.23_b,4,885
38,161,125,219,684,339,345,0,3,1,ABMrun_3.1.23_b,4,903
39,187,141,233,642,315,327,0,3,1,ABMrun_3.1.23_b,4,875
40,181,144,228,664,324,340,0,3,1,ABMrun_3.1.23_b,4,892
41,177,137,224,680,321,359,0,3,1,ABMrun_3.1.23_b,4,904
42,172,136,221,680,325,355,0,3,1,ABMrun_3.1.23_b,4,901
43,169,135,230,657,316,341,0,3,1,ABMrun_3.1.23_b,4,887
44,182,141,228,660,323,337,0,3,1,ABMrun_3.1.23_b,4,888
45,177,137,228,652,329,323,0,3,1,ABMrun_3.1.23_b,4,880
46,185,148,228,654,345,309,0,3,1,ABMrun_3.1.23_b,4,882
47,179,129,222,670,346,324,0,3,1,ABMrun_3.1.23_b,4,892
48,177,139,233,639,320,319,0,3,1,ABMrun_3.1.23_b,4,872
49,188,139,236,637,321,316,0,3,1,ABMrun_3.1.23_b,4,873
50,185,138,237,626,312,314,0,3,1,ABMrun_3.1.23_b,4,863
51,167,134,215,703,348,355,0,3,1,ABMrun_3.1.23_b,4,918
52,183,139,238,636,324,312,0,3,1,ABMrun_3.1.23_b,4,874
53,189,145,235,645,321,324,0,3,1,ABMrun_3.1.23_b,4,880
54,184,133,237,624,312,312,0,3,1,ABMrun_3.1.23_b,4,861
55,174,133,230,657,338,319,0,3,1,ABMrun_3.1.23_b,4,887
56,187,135,239,622,311,311,0,3,1,ABMrun_3.1.23_b,4,861
57,178,136,234,641,326,315,0,3,1,ABMrun_3.1.23_b,4,875
58,180,134,235,638,316,322,0,3,1,ABMrun_3.1.23_b,4,873
59,177,144,234,644,303,341,0,3,1,ABMrun_3.1.23_b,4,878
60,174,136,232,648,299,349,0,3,1,ABMrun_3.1.23_b,4,880
61,172,132,229,652,322,330,0,3,1,ABMrun_3.1.23_b,4,881
62,176,133,228,660,330,330,0,3,1,ABMrun_3.1.23_b,4,888
63,176,135,226,665,338,327,0,3,1,ABMrun_3.1.23_b,4,891
64,180,139,227,655,337,318,0,3,1,ABMrun_3.1.23_b,4,882
65,184,142,230,661,343,318,0,3,1,ABMrun_3.1.23_b,4,891
66,177,132,231,648,335,313,0,3,1,ABMrun_3.1.23_b,4,879
67,172,129,223,678,355,323,0,3,1,ABMrun_3.1.23_b,4,901
68,172,131,222,683,367,316,0,3,1,ABMrun_3.1.23_b,4,905
69,171,135,226,662,342,320,0,3,1,ABMrun_3.1.23_b,4,888
70,190,136,236,646,332,314,0,3,1,ABMrun_3.1.23_b,4,882
71,175,136,223,676,354,322,0,3,1,ABMrun_3.1.23_b,4,899
72,175,134,225,676,344,332,0,3,1,ABMrun_3.1.23_b,4,901
73,172,132,227,667,327,340,0,3,1,ABMrun_3.1.23_b,4,894
74,180,134,226,666,323,343,0,3,1,ABMrun_3.1.23_b,4,892
75,175,134,225,667,326,341,0,3,1,ABMrun_3.1.23_b,4,892
76,163,124,211,706,359,347,0,3,1,ABMrun_3.1.23_b,4,917
77,184,146,230,653,329,324,0,3,1,ABMrun_3.1.23_b,4,883
78,184,145,233,647,327,320,0,3,1,ABMrun_3.1.23_b,4,880
79,183,134,236,637,345,292,0,3,1,ABMrun_3.1.23_b,4,873
80,179,135,231,655,346,309,0,3,1,ABMrun_3.1.23_b,4,886
81,172,131,219,684,350,334,0,3,1,ABMrun_3.1.23_b,4,903
82,177,132,226,670,336,334,0,3,1,ABMrun_3.1.23_b,4,896
83,176,133,232,649,324,325,0,3,1,ABMrun_3.1.23_b,4,881
84,179,138,232,644,314,330,0,3,1,ABMrun_3.1.23_b,4,876
85,174,139,228,671,319,352,0,3,1,ABMrun_3.1.23_b,4,899
86,182,143,233,644,312,332,0,3,1,ABMrun_3.1.23_b,4,877
87,191,142,235,646,314,332,0,3,1,ABMrun_3.1.23_b,4,881
88,182,134,230,667,327,340,0,3,1,ABMrun_3.1.23_b,4,897
89,185,141,228,669,338,331,0,3,1,ABMrun_3.1.23_b,4,897
90,181,139,233,647,324,323,0,3,1,ABMrun_3.1.23_b,4,880
91,180,141,231,651,325,326,0,3,1,ABMrun_3.1.23_b,4,882
92,182,127,237,623,313,310,0,3,1,ABMrun_3.1.23_b,4,860
93,183,145,232,648,333,315,0,3,1,ABMrun_3.1.23_b,4,880
94,176,134,228,658,334,324,0,3,1,ABMrun_3.1.23_b,4,886
95,182,136,239,637,319,318,0,3,1,ABMrun_3.1.23_b,4,876
96,180,138,231,645,342,303,0,3,1,ABMrun_3.1.23_b,4,876
97,181,141,231,652,320,332,0,3,1,ABMrun_3.1.23_b,4,883
98,182,134,235,647,318,329,0,3,1,ABMrun_3.1.23_b,4,882
99,169,129,227,662,333,329,0,3,1,ABMrun_3.1.23_b,4,889
100,167,126,220,658,332,326,0,3,1,ABMrun_3.1.23_b,4,878
101,134,113,175,719,355,364,0,3,1,ABMrun_3.1.23_b,4,894
102,152,125,195,637,309,328,0,3,1,ABMrun_3.1.23_b,4,832
103,154,125,197,603,293,310,0,3,1,ABMrun_3.1.23_b,4,800
104,147,120,187,590,284,306,0,3,1,ABMrun_3.1.23_b,4,777
105,138,101,180,567,299,268,0,3,1,ABMrun_3.1.23_b,4,747
106,130,99,173,545,293,252,0,3,1,ABMrun_3.1.23_b,4,718
107,128,101,163,536,280,256,0,3,1,ABMrun_3.1.23_b,4,699
108,116,91,155,518,260,258,0,3,1,ABMrun_3.1.23_b,4,673
109,112,93,147,501,237,264,0,3,1,ABMrun_3.1.23_b,4,648
110,60,52,78,466,220,246,0,3,1,ABMrun_3.1.23_b,4,544
111,68,57,89,383,166,217,0,3,1,ABMrun_3.1.23_b,4,472
112,66,58,86,334,144,190,0,3,1,ABMrun_3.1.23_b,4,420
113,67,55,82,279,132,147,0,3,1,ABMrun_3.1.23_b,4,361
114,62,53,82,264,130,134,0,3,1,ABMrun_3.1.23_b,4,346
115,66,51,82,248,120,128,0,3,1,ABMrun_3.1.23_b,4,330
116,69,55,81,251,127,124,0,3,1,ABMrun_3.1.23_b,4,332
117,66,48,79,256,129,127,0,3,1,ABMrun_3.1.23_b,4,335
118,62,47,80,249,113,136,0,3,1,ABMrun_3.1.23_b,4,329
119,61,53,80,254,121,133,0,3,1,ABMrun_3.1.23_b,4,334
120,60,43,75,233,106,127,0,3,1,ABMrun_3.1.23_b,4,308
121,60,43,74,225,108,117,0,3,1,ABMrun_3.1.23_b,4,299
122,59,47,76,220,108,112,0,3,1,ABMrun_3.1.23_b,4,296
123,59,43,76,224,102,122,0,3,1,ABMrun_3.1.23_b,4,300
124,56,39,73,216,103,113,0,3,1,ABMrun_3.1.23_b,4,289
125,56,44,73,219,105,114,0,3,1,ABMrun_3.1.23_b,4,292
126,59,48,75,216,101,115,0,3,1,ABMrun_3.1.23_b,4,291
127,53,44,72,208,108,100,0,3,1,ABMrun_3.1.23_b,4,280
128,55,39,74,216,115,101,0,3,1,ABMrun_3.1.23_b,4,290
129,60,46,72,210,104,106,0,3,1,ABMrun_3.1.23_b,4,282
130,56,48,73,212,100,112,0,3,1,ABMrun_3.1.23_b,4,285
131,57,47,76,226,107,119,0,3,1,ABMrun_3.1.23_b,4,302
132,58,48,74,224,105,119,0,3,1,ABMrun_3.1.23_b,4,298
133,62,46,77,224,108,116,0,3,1,ABMrun_3.1.23_b,4,301
134,59,46,74,218,92,126,0,3,1,ABMrun_3.1.23_b,4,292
135,55,38,74,224,106,118,0,3,1,ABMrun_3.1.23_b,4,298
136,58,45,76,221,106,115,0,3,1,ABMrun_3.1.23_b,4,297
137,56,41,70,198,101,97,0,3,1,ABMrun_3.1.23_b,4,268
138,54,42,70,203,110,93,0,3,1,ABMrun_3.1.23_b,4,273
139,57,43,73,219,117,102,0,3,1,ABMrun_3.1.23_b,4,292
140,61,42,77,225,123,102,0,3,1,ABMrun_3.1.23_b,4,302
141,58,41,72,204,121,83,0,3,1,ABMrun_3.1.23_b,4,276
142,55,44,72,208,116,92,0,3,1,ABMrun_3.1.23_b,4,280
143,60,39,72,209,125,84,0,3,1,ABMrun_3.1.23_b,4,281
144,55,40,69,196,107,89,0,3,1,ABMrun_3.1.23_b,4,265
145,53,38,69,193,103,90,0,3,1,ABMrun_3.1.23_b,4,262
146,49,36,62,176,91,85,0,3,1,ABMrun_3.1.23_b,4,238
147,45,32,57,162,83,79,0,3,1,ABMrun_3.1.23_b,4,219
148,49,34,62,162,83,79,0,3,1,ABMrun_3.1.23_b,4,224
149,52,39,64,172,88,84,0,3,1,ABMrun_3.1.23_b,4,236
150,48,37,62,167,85,82,0,3,1,ABMrun_3.1.23_b,4,229
151,84,53,130,184,89,95,0,3,1,ABMrun_3.1.23_b,4,314
152,112,77,168,257,118,139,2,3,1,ABMrun_3.1.23_b,4,425
153,138,92,194,347,158,189,2,3,1,ABMrun_3.1.23_b,4,541
154,155,106,205,432,198,234,0,3,1,ABMrun_3.1.23_b,4,637
155,157,118,208,492,237,255,1,3,1,ABMrun_3.1.23_b,4,700
156,168,136,205,565,282,283,1,3,1,ABMrun_3.1.23_b,4,770
157,167,127,216,577,278,299,1,3,1,ABMrun_3.1.23_b,4,793
158,172,143,221,600,291,309,1,3,1,ABMrun_3.1.23_b,4,821
159,178,134,233,592,286,306,1,3,1,ABMrun_3.1.23_b,4,825
160,181,135,242,614,287,327,0,3,1,ABMrun_3.1.23_b,4,856
161,182,136,229,657,312,345,2,3,1,ABMrun_3.1.23_b,4,886
162,181,134,231,660,329,331,1,3,1,ABMrun_3.1.23_b,4,891
163,180,135,230,654,333,321,2,3,1,ABMrun_3.1.23_b,4,884
164,185,132,233,650,333,317,2,3,1,ABMrun_3.1.23_b,4,883
165,185,144,237,633,326,307,2,3,1,ABMrun_3.1.23_b,4,870
166,180,131,227,664,337,327,1,3,1,ABMrun_3.1.23_b,4,891
167,169,139,217,688,362,326,0,3,1,ABMrun_3.1.23_b,4,905
168,183,133,230,648,329,319,1,3,1,ABMrun_3.1.23_b,4,878
169,183,145,238,642,337,305,0,3,1,ABMrun_3.1.23_b,4,880
170,176,131,228,667,340,327,3,3,1,ABMrun_3.1.23_b,4,895
171,177,135,224,670,328,342,2,3,1,ABMrun_3.1.23_b,4,894
172,170,136,224,674,327,347,1,3,1,ABMrun_3.1.23_b,4,898
173,175,135,223,676,324,352,0,3,1,ABMrun_3.1.23_b,4,899
174,178,131,224,667,331,336,2,3,1,ABMrun_3.1.23_b,4,891
175,174,135,224,665,346,319,1,3,1,ABMrun_3.1.23_b,4,889
176,166,125,211,709,387,322,1,3,1,ABMrun_3.1.23_b,4,920
177,180,140,228,666,355,311,2,3,1,ABMrun_3.1.23_b,4,894
178,183,143,228,651,306,345,1,3,1,ABMrun_3.1.23_b,4,879
179,184,138,237,637,270,367,0,3,1,ABMrun_3.1.23_b,4,874
180,172,134,219,681,304,377,1,3,1,ABMrun_3.1.23_b,4,900
181,177,139,222,677,294,383,1,3,1,ABMrun_3.1.23_b,4,899
182,186,140,231,659,291,368,0,3,1,ABMrun_3.1.23_b,4,890
183,173,137,227,666,305,361,1,3,1,ABMrun_3.1.23_b,4,893
184,171,132,227,659,312,347,0,3,1,ABMrun_3.1.23_b,4,886
185,175,134,231,648,306,342,0,3,1,ABMrun_3.1.23_b,4,879
186,179,138,228,661,307,354,1,3,1,ABMrun_3.1.23_b,4,889
187,171,137,221,679,324,355,0,3,1,ABMrun_3.1.23_b,4,900
188,184,137,230,653,308,345,0,3,1,ABMrun_3.1.23_b,4,883
189,175,135,230,652,333,319,0,3,1,ABMrun_3.1.23_b,4,882
190,180,140,227,659,338,321,2,3,1,ABMrun_3.1.23_b,4,886
191,169,130,224,669,331,338,1,3,1,ABMrun_3.1.23_b,4,893
192,183,141,226,666,317,349,0,3,1,ABMrun_3.1.23_b,4,892
193,177,135,229,654,315,339,1,3,1,ABMrun_3.1.23_b,4,883
194,170,132,219,693,320,373,1,3,1,ABMrun_3.1.23_b,4,912
195,174,135,225,664,322,342,0,3,1,ABMrun_3.1.23_b,4,889
196,179,144,226,672,304,368,0,3,1,ABMrun_3.1.23_b,4,898
197,164,134,219,681,322,359,2,3,1,ABMrun_3.1.23_b,4,900
198,176,137,222,672,317,355,1,3,1,ABMrun_3.1.23_b,4,894
199,176,132,221,683,339,344,1,3,1,ABMrun_3.1.23_b,4,904
200,174,135,225,678,336,342,0,3,1,ABMrun_3.1.23_b,4,903
201,160,133,204,719,348,371,0,3,1,ABMrun_3.1.23_b,4,923
202,181,126,224,671,342,329,1,3,1,ABMrun_3.1.23_b,4,895
203,174,129,225,667,336,331,2,3,1,ABMrun_3.1.23_b,4,892
204,177,137,226,662,318,344,0,3,1,ABMrun_3.1.23_b,4,888
205,182,140,229,660,322,338,0,3,1,ABMrun_3.1.23_b,4,889
206,180,146,228,666,333,333,1,3,1,ABMrun_3.1.23_b,4,894
207,173,135,223,673,339,334,1,3,1,ABMrun_3.1.23_b,4,896
208,178,134,225,669,333,336,0,3,1,ABMrun_3.1.23_b,4,894
209,167,128,217,685,342,343,2,3,1,ABMrun_3.1.23_b,4,902
210,172,136,230,645,319,326,1,3,1,ABMrun_3.1.23_b,4,875
211,173,135,227,665,332,333,0,3,1,ABMrun_3.1.23_b,4,892
212,182,139,229,657,308,349,2,3,1,ABMrun_3.1.23_b,4,886
213,190,148,232,649,299,350,1,3,1,ABMrun_3.1.23_b,4,881
214,164,138,215,694,337,357,0,3,1,ABMrun_3.1.23_b,4,909
215,172,143,223,666,327,339,1,3,1,ABMrun_3.1.23_b,4,889
216,178,139,234,641,316,325,1,3,1,ABMrun_3.1.23_b,4,875
217,176,137,224,675,322,353,1,3,1,ABMrun_3.1.23_b,4,899
218,172,140,219,680,328,352,1,3,1,ABMrun_3.1.23_b,4,899
219,188,147,235,639,310,329,2,3,1,ABMrun_3.1.23_b,4,874
220,181,140,233,633,317,316,2,3,1,ABMrun_3.1.23_b,4,866
221,176,128,229,660,327,333,0,3,1,ABMrun_3.1.23_b,4,889
222,175,133,223,671,328,343,1,3,1,ABMrun_3.1.23_b,4,894
223,172,127,228,660,316,344,1,3,1,ABMrun_3.1.23_b,4,888
224,179,140,230,658,322,336,1,3,1,ABMrun_3.1.23_b,4,888
225,175,133,226,664,330,334,1,3,1,ABMrun_3.1.23_b,4,890
226,160,130,205,721,354,367,0,3,1,ABMrun_3.1.23_b,4,926
227,172,131,230,649,326,323,2,3,1,ABMrun_3.1.23_b,4,879
228,168,129,222,675,344,331,1,3,1,ABMrun_3.1.23_b,4,897
229,167,130,212,695,352,343,0,3,1,ABMrun_3.1.23_b,4,907
230,166,133,218,683,336,347,0,3,1,ABMrun_3.1.23_b,4,901
231,176,136,233,645,309,336,2,3,1,ABMrun_3.1.23_b,4,878
232,178,143,233,639,299,340,1,3,1,ABMrun_3.1.23_b,4,872
233,173,140,226,670,314,356,0,3,1,ABMrun_3.1.23_b,4,896
234,179,139,229,664,309,355,0,3,1,ABMrun_3.1.23_b,4,893
235,171,135,228,657,296,361,1,3,1,ABMrun_3.1.23_b,4,885
236,176,138,224,668,315,353,0,3,1,ABMrun_3.1.23_b,4,892
237,174,137,223,676,334,342,1,3,1,ABMrun_3.1.23_b,4,899
238,167,128,224,673,338,335,1,3,1,ABMrun_3.1.23_b,4,897
239,177,138,223,668,347,321,1,3,1,ABMrun_3.1.23_b,4,891
240,168,133,216,687,355,332,2,3,1,ABMrun_3.1.23_b,4,903
241,180,135,230,650,322,328,0,3,1,ABMrun_3.1.23_b,4,880
242,180,134,225,659,334,325,0,3,1,ABMrun_3.1.23_b,4,884
243,178,133,228,659,323,336,1,3,1,ABMrun_3.1.23_b,4,887
244,181,127,232,647,323,324,1,3,1,ABMrun_3.1.23_b,4,879
245,179,133,228,658,316,342,0,3,1,ABMrun_3.1.23_b,4,886
246,186,147,231,648,298,350,0,3,1,ABMrun_3.1.23_b,4,879
247,174,139,221,686,315,371,1,3,1,ABMrun_3.1.23_b,4,907
248,171,131,222,676,328,348,1,3,1,ABMrun_3.1.23_b,4,898
249,178,147,228,656,332,324,0,3,1,ABMrun_3.1.23_b,4,884
250,175,141,224,662,334,328,2,3,1,ABMrun_3.1.23_b,4,886
251,166,133,206,715,367,348,1,3,1,ABMrun_3.1.23_b,4,921
252,171,137,221,676,333,343,0,3,1,ABMrun_3.1.23_b,4,897
253,174,137,224,668,332,336,0,3,1,ABMrun_3.1.23_b,4,892
254,174,146,227,665,334,331,1,3,1,ABMrun_3.1.23_b,4,892
255,179,140,224,674,330,344,1,3,1,ABMrun_3.1.23_b,4,898
256,172,146,215,692,346,346,1,3,1,ABMrun_3.1.23_b,4,907
257,168,131,221,675,323,352,2,3,1,ABMrun_3.1.23_b,4,896
258,177,145,224,669,311,358,2,3,1,ABMrun_3.1.23_b,4,893
259,173,138,225,662,314,348,1,3,1,ABMrun_3.1.23_b,4,887
260,183,137,233,644,306,338,0,3,1,ABMrun_3.1.23_b,4,877
261,179,137,234,640,315,325,2,3,1,ABMrun_3.1.23_b,4,874
262,176,135,223,677,324,353,0,3,1,ABMrun_3.1.23_b,4,900
263,174,137,227,664,316,348,1,3,1,ABMrun_3.1.23_b,4,891
264,176,144,228,658,323,335,1,3,1,ABMrun_3.1.23_b,4,886
265,180,126,233,644,324,320,0,3,1,ABMrun_3.1.23_b,4,877
266,176,130,222,676,336,340,2,3,1,ABMrun_3.1.23_b,4,898
267,169,130,228,661,335,326,1,3,1,ABMrun_3.1.23_b,4,889
268,176,137,227,657,327,330,3,3,1,ABMrun_3.1.23_b,4,884
269,180,131,231,648,322,326,0,3,1,ABMrun_3.1.23_b,4,879
270,169,138,217,675,333,342,1,3,1,ABMrun_3.1.23_b,4,892
271,183,147,234,643,318,325,1,3,1,ABMrun_3.1.23_b,4,877
272,177,129,230,654,325,329,1,3,1,ABMrun_3.1.23_b,4,884
273,174,134,225,673,329,344,2,3,1,ABMrun_3.1.23_b,4,898
274,160,128,211,703,359,344,1,3,1,ABMrun_3.1.23_b,4,914
275,175,133,224,676,345,331,0,3,1,ABMrun_3.1.23_b,4,900
276,150,129,204,721,358,363,2,3,1,ABMrun_3.1.23_b,4,925
277,174,141,219,681,340,341,0,3,1,ABMrun_3.1.23_b,4,900
278,178,139,227,664,336,328,1,3,1,ABMrun_3.1.23_b,4,891
279,171,128,223,669,345,324,0,3,1,ABMrun_3.1.23_b,4,892
280,172,125,220,679,360,319,0,3,1,ABMrun_3.1.23_b,4,899
281,178,139,225,662,338,324,1,3,1,ABMrun_3.1.23_b,4,887
282,181,144,228,649,321,328,2,3,1,ABMrun_3.1.23_b,4,877
283,172,133,214,692,347,345,0,3,1,ABMrun_3.1.23_b,4,906
284,182,141,229,656,321,335,3,3,1,ABMrun_3.1.23_b,4,885
285,172,133,221,684,345,339,1,3,1,ABMrun_3.1.23_b,4,905
286,168,129,216,685,338,347,1,3,1,ABMrun_3.1.23_b,4,901
287,170,131,228,661,325,336,1,3,1,ABMrun_3.1.23_b,4,889
288,169,138,225,666,308,358,2,3,1,ABMrun_3.1.23_b,4,891
289,172,133,224,666,306,360,1,3,1,ABMrun_3.1.23_b,4,890
290,171,136,229,657,306,351,0,3,1,ABMrun_3.1.23_b,4,886
291,177,145,221,675,318,357,1,3,1,ABMrun_3.1.23_b,4,896
292,185,143,236,635,293,342,2,3,1,ABMrun_3.1.23_b,4,871
293,178,145,231,656,294,362,1,3,1,ABMrun_3.1.23_b,4,887
294,185,139,234,629,280,349,0,3,1,ABMrun_3.1.23_b,4,863
295,177,138,224,674,320,354,0,3,1,ABMrun_3.1.23_b,4,898
296,181,139,224,664,316,348,1,3,1,ABMrun_3.1.23_b,4,888
297,172,132,229,666,313,353,0,3,1,ABMrun_3.1.23_b,4,895
298,171,134,218,681,320,361,0,3,1,ABMrun_3.1.23_b,4,899
299,175,139,230,645,310,335,1,3,1,ABMrun_3.1.23_b,4,875
300,186,144,229,658,316,342,1,3,1,ABMrun_3.1.23_b,4,887
301,155,129,198,730,347,383,1,3,1,ABMrun_3.1.23_b,4,928
302,173,130,223,675,336,339,1,3,1,ABMrun_3.1.23_b,4,898
303,179,138,230,654,326,328,0,3,1,ABMrun_3.1.23_b,4,884
304,177,140,224,670,321,349,2,3,1,ABMrun_3.1.23_b,4,894
305,175,140,223,671,320,351,2,3,1,ABMrun_3.1.23_b,4,894
306,177,144,230,651,314,337,1,3,1,ABMrun_3.1.23_b,4,881
307,176,133,226,663,324,339,0,3,1,ABMrun_3.1.23_b,4,889
308,172,141,225,667,316,351,1,3,1,ABMrun_3.1.23_b,4,892
309,178,133,230,644,310,334,0,3,1,ABMrun_3.1.23_b,4,874
310,172,129,225,661,334,327,1,3,1,ABMrun_3.1.23_b,4,886
311,185,150,233,647,320,327,2,3,1,ABMrun_3.1.23_b,4,880
312,183,140,231,649,330,319,0,3,1,ABMrun_3.1.23_b,4,880
313,181,136,227,659,321,338,0,3,1,ABMrun_3.1.23_b,4,886
314,180,146,222,674,333,341,2,3,1,ABMrun_3.1.23_b,4,896
315,176,145,218,684,324,360,0,3,1,ABMrun_3.1.23_b,4,902
316,171,137,227,655,316,339,1,3,1,ABMrun_3.1.23_b,4,882
317,178,136,231,654,321,333,0,3,1,ABMrun_3.1.23_b,4,885
318,171,134,229,660,325,335,0,3,1,ABMrun_3.1.23_b,4,889
319,179,135,229,648,327,321,0,3,1,ABMrun_3.1.23_b,4,877
320,180,134,230,649,323,326,0,3,1,ABMrun_3.1.23_b,4,879
321,185,137,236,635,317,318,0,3,1,ABMrun_3.1.23_b,4,871
322,172,130,230,650,325,325,0,3,1,ABMrun_3.1.23_b,4,880
323,178,139,221,666,339,327,0,3,1,ABMrun_3.1.23_b,4,887
324,180,137,228,657,337,320,0,3,1,ABMrun_3.1.23_b,4,885
325,174,142,221,670,356,314,0,3,1,ABMrun_3.1.23_b,4,891
326,163,132,209,707,378,329,0,3,1,ABMrun_3.1.23_b,4,916
327,170,135,223,666,362,304,1,3,1,ABMrun_3.1.23_b,4,889
328,188,142,227,656,346,310,0,3,1,ABMrun_3.1.23_b,4,883
329,175,138,228,659,330,329,1,3,1,ABMrun_3.1.23_b,4,887
330,177,133,231,655,336,319,1,3,1,ABMrun_3.1.23_b,4,886
331,176,134,229,656,330,326,1,3,1,ABMrun_3.1.23_b,4,885
332,174,138,223,671,335,336,1,3,1,ABMrun_3.1.23_b,4,894
333,173,133,225,667,335,332,0,3,1,ABMrun_3.1.23_b,4,892
334,172,133,222,674,339,335,0,3,1,ABMrun_3.1.23_b,4,896
335,169,143,226,665,319,346,2,3,1,ABMrun_3.1.23_b,4,891
336,174,144,225,666,302,364,0,3,1,ABMrun_3.1.23_b,4,891
337,177,138,228,667,325,342,1,3,1,ABMrun_3.1.23_b,4,895
338,174,134,230,649,305,344,0,3,1,ABMrun_3.1.23_b,4,879
339,181,136,234,643,296,347,1,3,1,ABMrun_3.1.23_b,4,877
340,178,130,223,670,321,349,0,3,1,ABMrun_3.1.23_b,4,893
341,173,141,229,655,330,325,1,3,1,ABMrun_3.1.23_b,4,884
342,171,135,222,671,337,334,1,3,1,ABMrun_3.1.23_b,4,893
343,181,140,226,660,336,324,1,3,1,ABMrun_3.1.23_b,4,886
344,173,129,226,666,337,329,0,3,1,ABMrun_3.1.23_b,4,892
345,178,147,234,649,341,308,0,3,1,ABMrun_3.1.23_b,4,883
346,178,134,233,651,334,317,1,3,1,ABMrun_3.1.23_b,4,884
347,182,134,230,648,306,342,1,3,1,ABMrun_3.1.23_b,4,878
348,172,141,224,669,317,352,0,3,1,ABMrun_3.1.23_b,4,893
349,177,141,228,655,317,338,2,3,1,ABMrun_3.1.23_b,4,883
350,174,141,227,664,318,346,2,3,1,ABMrun_3.1.23_b,4,891
1,15,15,16,600,312,288,0,1,1,ABMrun_3.1.23_b,5,616
2,78,74,104,882,444,438,0,1,1,ABMrun_3.1.23_b,5,986
3,137,113,169,796,409,387,0,1,1,ABMrun_3.1.23_b,5,965
4,158,132,207,718,369,349,0,1,1,ABMrun_3.1.23_b,5,925
5,181,129,225,669,333,336,0,1,1,ABMrun_3.1.23_b,5,894
6,179,129,235,642,325,317,0,1,1,ABMrun_3.1.23_b,5,877
7,173,129,230,654,340,314,0,1,1,ABMrun_3.1.23_b,5,884
8,180,129,235,644,343,301,0,1,1,ABMrun_3.1.23_b,5,879
9,179,143,230,651,333,318,0,1,1,ABMrun_3.1.23_b,5,881
10,177,138,234,645,333,312,0,1,1,ABMrun_3.1.23_b,5,879
11,182,140,234,643,351,292,0,1,1,ABMrun_3.1.23_b,5,877
12,177,137,231,655,345,310,0,1,1,ABMrun_3.1.23_b,5,886
13,182,139,231,658,347,311,0,1,1,ABMrun_3.1.23_b,5,889
14,164,131,224,670,359,311,0,1,1,ABMrun_3.1.23_b,5,894
15,181,138,232,661,330,331,0,1,1,ABMrun_3.1.23_b,5,893
16,182,135,234,648,329,319,0,1,1,ABMrun_3.1.23_b,5,882
17,183,125,234,636,335,301,0,1,1,ABMrun_3.1.23_b,5,870
18,175,145,233,653,323,330,0,1,1,ABMrun_3.1.23_b,5,886
19,186,139,233,647,322,325,0,1,1,ABMrun_3.1.23_b,5,880
20,172,138,225,672,334,338,0,1,1,ABMrun_3.1.23_b,5,897
21,177,139,226,666,338,328,0,1,1,ABMrun_3.1.23_b,5,892
22,176,134,228,658,339,319,0,1,1,ABMrun_3.1.23_b,5,886
23,181,141,234,655,337,318,0,1,1,ABMrun_3.1.23_b,5,889
24,183,136,231,657,330,327,0,1,1,ABMrun_3.1.23_b,5,888
25,178,136,231,657,331,326,0,1,1,ABMrun_3.1.23_b,5,888
26,169,135,215,704,349,355,0,1,1,ABMrun_3.1.23_b,5,919
27,179,139,228,652,326,326,0,1,1,ABMrun_3.1.23_b,5,880
28,178,137,228,664,342,322,0,1,1,ABMrun_3.1.23_b,5,892
29,188,148,236,641,308,333,0,1,1,ABMrun_3.1.23_b,5,877
30,183,141,234,651,314,337,0,1,1,ABMrun_3.1.23_b,5,885
31,183,144,229,657,309,348,0,1,1,ABMrun_3.1.23_b,5,886
32,182,137,226,675,330,345,0,1,1,ABMrun_3.1.23_b,5,901
33,180,144,234,636,321,315,0,1,1,ABMrun_3.1.23_b,5,870
34,178,136,233,649,329,320,0,1,1,ABMrun_3.1.23_b,5,882
35,176,140,231,649,316,333,0,1,1,ABMrun_3.1.23_b,5,880
36,182,146,234,639,304,335,0,1,1,ABMrun_3.1.23_b,5,873
37,173,132,226,672,328,344,0,1,1,ABMrun_3.1.23_b,5,898
38,174,127,224,665,338,327,0,1,1,ABMrun_3.1.23_b,5,889
39,174,136,228,651,317,334,0,1,1,ABMrun_3.1.23_b,5,879
40,178,144,228,657,318,339,0,1,1,ABMrun_3.1.23_b,5,885
41,173,141,225,668,317,351,0,1,1,ABMrun_3.1.23_b,5,893
42,178,146,229,653,317,336,0,1,1,ABMrun_3.1.23_b,5,882
43,182,136,234,633,327,306,0,1,1,ABMrun_3.1.23_b,5,867
44,184,140,230,660,331,329,0,1,1,ABMrun_3.1.23_b,5,890
45,182,142,222,673,312,361,0,1,1,ABMrun_3.1.23_b,5,895
46,179,147,230,656,292,364,0,1,1,ABMrun_3.1.23_b,5,886
47,175,136,228,662,306,356,0,1,1,ABMrun_3.1.23_b,5,890
48,188,148,235,641,317,324,0,1,1,ABMrun_3.1.23_b,5,876
49,183,131,236,647,310,337,0,1,1,ABMrun_3.1.23_b,5,883
50,179,144,231,658,321,337,0,1,1,ABMrun_3.1.23_b,5,889
51,168,136,209,721,348,373,0,1,1,ABMrun_3.1.23_b,5,930
52,186,137,233,644,328,316,0,1,1,ABMrun_3.1.23_b,5,877
53,176,138,228,658,319,339,0,1,1,ABMrun_3.1.23_b,5,886
54,178,142,226,659,318,341,0,1,1,ABMrun_3.1.23_b,5,885
55,175,135,222,668,321,347,0,1,1,ABMrun_3.1.23_b,5,890
56,181,136,235,641,304,337,0,1,1,ABMrun_3.1.23_b,5,876
57,183,143,235,635,310,325,0,1,1,ABMrun_3.1.23_b,5,870
58,175,138,226,670,332,338,0,1,1,ABMrun_3.1.23_b,5,896
59,183,142,237,643,313,330,0,1,1,ABMrun_3.1.23_b,5,880
60,183,138,233,640,304,336,0,1,1,ABMrun_3.1.23_b,5,873
61,180,143,230,655,315,340,0,1,1,ABMrun_3.1.23_b,5,885
62,174,133,228,664,318,346,0,1,1,ABMrun_3.1.23_b,5,892
63,174,138,232,640,322,318,0,1,1,ABMrun_3.1.23_b,5,872
64,187,142,229,653,318,335,0,1,1,ABMrun_3.1.23_b,5,882
65,171,128,223,669,334,335,0,1,1,ABMrun_3.1.23_b,5,892
66,181,140,230,652,328,324,0,1,1,ABMrun_3.1.23_b,5,882
67,189,142,237,638,335,303,0,1,1,ABMrun_3.1.23_b,5,875
68,178,139,233,643,339,304,0,1,1,ABMrun_3.1.23_b,5,876
69,178,129,226,669,358,311,0,1,1,ABMrun_3.1.23_b,5,895
70,185,143,233,634,331,303,0,1,1,ABMrun_3.1.23_b,5,867
71,177,139,233,641,331,310,0,1,1,ABMrun_3.1.23_b,5,874
72,180,138,234,649,329,320,0,1,1,ABMrun_3.1.23_b,5,883
73,181,138,236,634,317,317,0,1,1,ABMrun_3.1.23_b,5,870
74,186,136,235,648,328,320,0,1,1,ABMrun_3.1.23_b,5,883
75,177,142,225,669,335,334,0,1,1,ABMrun_3.1.23_b,5,894
76,169,133,220,699,361,338,0,1,1,ABMrun_3.1.23_b,5,919
77,177,128,228,660,343,317,0,1,1,ABMrun_3.1.23_b,5,888
78,177,136,224,674,346,328,0,1,1,ABMrun_3.1.23_b,5,898
79,180,132,223,670,361,309,0,1,1,ABMrun_3.1.23_b,5,893
80,183,141,230,655,347,308,0,1,1,ABMrun_3.1.23_b,5,885
81,178,136,226,667,326,341,0,1,1,ABMrun_3.1.23_b,5,893
82,189,135,231,645,318,327,0,1,1,ABMrun_3.1.23_b,5,876
83,178,142,234,644,307,337,0,1,1,ABMrun_3.1.23_b,5,878
84,179,136,232,643,299,344,0,1,1,ABMrun_3.1.23_b,5,875
85,174,138,225,669,315,354,0,1,1,ABMrun_3.1.23_b,5,894
86,182,155,230,658,319,339,0,1,1,ABMrun_3.1.23_b,5,888
87,184,137,235,637,298,339,0,1,1,ABMrun_3.1.23_b,5,872
88,180,143,230,653,305,348,0,1,1,ABMrun_3.1.23_b,5,883
89,175,142,232,651,307,344,0,1,1,ABMrun_3.1.23_b,5,883
90,175,136,229,665,316,349,0,1,1,ABMrun_3.1.23_b,5,894
91,179,148,228,658,315,343,0,1,1,ABMrun_3.1.23_b,5,886
92,174,146,225,668,304,364,0,1,1,ABMrun_3.1.23_b,5,893
93,182,132,224,676,325,351,0,1,1,ABMrun_3.1.23_b,5,900
94,174,135,224,669,328,341,0,1,1,ABMrun_3.1.23_b,5,893
95,179,140,231,658,328,330,0,1,1,ABMrun_3.1.23_b,5,889
96,180,141,230,656,314,342,0,1,1,ABMrun_3.1.23_b,5,886
97,175,139,225,675,327,348,0,1,1,ABMrun_3.1.23_b,5,900
98,177,143,229,657,328,329,0,1,1,ABMrun_3.1.23_b,5,886
99,173,135,222,685,348,337,0,1,1,ABMrun_3.1.23_b,5,907
100,162,129,210,671,333,338,0,1,1,ABMrun_3.1.23_b,5,881
101,149,123,192,682,351,331,0,1,1,ABMrun_3.1.23_b,5,874
102,164,124,202,614,310,304,0,1,1,ABMrun_3.1.23_b,5,816
103,158,123,200,588,297,291,0,1,1,ABMrun_3.1.23_b,5,788
104,137,112,180,601,307,294,0,1,1,ABMrun_3.1.23_b,5,781
105,144,114,183,560,288,272,0,1,1,ABMrun_3.1.23_b,5,743
106,137,108,171,548,281,267,0,1,1,ABMrun_3.1.23_b,5,719
107,126,104,157,546,274,272,0,1,1,ABMrun_3.1.23_b,5,703
108,130,103,162,491,259,232,0,1,1,ABMrun_3.1.23_b,5,653
109,119,97,147,492,255,237,0,1,1,ABMrun_3.1.23_b,5,639
110,61,50,78,483,257,226,0,1,1,ABMrun_3.1.23_b,5,561
111,69,59,87,395,204,191,0,1,1,ABMrun_3.1.23_b,5,482
112,66,58,87,325,161,164,0,1,1,ABMrun_3.1.23_b,5,412
113,69,55,86,294,141,153,0,1,1,ABMrun_3.1.23_b,5,380
114,62,54,82,285,139,146,0,1,1,ABMrun_3.1.23_b,5,367
115,60,51,83,264,135,129,0,1,1,ABMrun_3.1.23_b,5,347
116,65,50,81,258,140,118,0,1,1,ABMrun_3.1.23_b,5,339
117,58,44,77,244,133,111,0,1,1,ABMrun_3.1.23_b,5,321
118,57,43,75,234,129,105,0,1,1,ABMrun_3.1.23_b,5,309
119,56,44,77,232,115,117,0,1,1,ABMrun_3.1.23_b,5,309
120,58,41,73,215,113,102,0,1,1,ABMrun_3.1.23_b,5,288
121,56,40,74,214,119,95,0,1,1,ABMrun_3.1.23_b,5,288
122,56,42,74,227,121,106,0,1,1,ABMrun_3.1.23_b,5,301
123,57,42,75,217,112,105,0,1,1,ABMrun_3.1.23_b,5,292
124,57,42,74,212,104,108,0,1,1,ABMrun_3.1.23_b,5,286
125,56,43,73,212,102,110,0,1,1,ABMrun_3.1.23_b,5,285
126,60,41,78,227,115,112,0,1,1,ABMrun_3.1.23_b,5,305
127,58,48,76,232,127,105,0,1,1,ABMrun_3.1.23_b,5,308
128,62,42,76,218,121,97,0,1,1,ABMrun_3.1.23_b,5,294
129,55,42,71,205,110,95,0,1,1,ABMrun_3.1.23_b,5,276
130,55,41,68,197,96,101,0,1,1,ABMrun_3.1.23_b,5,265
131,54,45,68,195,99,96,0,1,1,ABMrun_3.1.23_b,5,263
132,51,39,66,179,100,79,0,1,1,ABMrun_3.1.23_b,5,245
133,52,40,66,175,98,77,0,1,1,ABMrun_3.1.23_b,5,241
134,52,40,67,182,107,75,0,1,1,ABMrun_3.1.23_b,5,249
135,54,37,67,190,104,86,0,1,1,ABMrun_3.1.23_b,5,257
136,53,37,68,192,101,91,0,1,1,ABMrun_3.1.23_b,5,260
137,54,46,68,190,96,94,0,1,1,ABMrun_3.1.23_b,5,258
138,55,43,66,180,89,91,0,1,1,ABMrun_3.1.23_b,5,246
139,50,35,65,182,93,89,0,1,1,ABMrun_3.1.23_b,5,247
140,47,33,65,179,90,89,0,1,1,ABMrun_3.1.23_b,5,244
141,50,37,64,170,91,79,0,1,1,ABMrun_3.1.23_b,5,234
142,50,39,66,182,103,79,0,1,1,ABMrun_3.1.23_b,5,248
143,52,37,67,190,105,85,0,1,1,ABMrun_3.1.23_b,5,257
144,55,44,69,198,100,98,0,1,1,ABMrun_3.1.23_b,5,267
145,56,45,69,199,98,101,0,1,1,ABMrun_3.1.23_b,5,268
146,54,43,68,192,93,99,0,1,1,ABMrun_3.1.23_b,5,260
147,58,47,70,198,99,99,0,1,1,ABMrun_3.1.23_b,5,268
148,55,41,70,201,97,104,0,1,1,ABMrun_3.1.23_b,5,271
149,51,42,70,190,93,97,0,1,1,ABMrun_3.1.23_b,5,260
150,53,40,70,193,97,96,0,1,1,ABMrun_3.1.23_b,5,263
151,132,88,176,304,159,145,64,1,1,ABMrun_3.1.23_b,5,480
152,144,90,188,358,194,164,36,1,1,ABMrun_3.1.23_b,5,546
153,158,106,196,436,224,212,17,1,1,ABMrun_3.1.23_b,5,632
154,152,106,199,501,252,249,8,1,1,ABMrun_3.1.23_b,5,700
155,147,117,200,532,265,267,2,1,1,ABMrun_3.1.23_b,5,732
156,154,125,204,564,279,285,1,1,1,ABMrun_3.1.23_b,5,768
157,160,132,207,600,289,311,0,1,1,ABMrun_3.1.23_b,5,807
158,174,127,221,596,292,304,0,1,1,ABMrun_3.1.23_b,5,817
159,184,143,229,610,298,312,0,1,1,ABMrun_3.1.23_b,5,839
160,174,132,232,637,321,316,0,1,1,ABMrun_3.1.23_b,5,869
161,174,139,223,671,330,341,0,1,1,ABMrun_3.1.23_b,5,894
162,170,137,220,686,347,339,0,1,1,ABMrun_3.1.23_b,5,906
163,173,133,221,678,338,340,0,1,1,ABMrun_3.1.23_b,5,899
164,172,134,223,675,339,336,0,1,1,ABMrun_3.1.23_b,5,898
165,171,133,227,661,328,333,0,1,1,ABMrun_3.1.23_b,5,888
166,178,137,227,658,312,346,0,1,1,ABMrun_3.1.23_b,5,885
167,172,130,229,654,309,345,0,1,1,ABMrun_3.1.23_b,5,883
168,179,144,224,670,329,341,0,1,1,ABMrun_3.1.23_b,5,894
169,166,130,220,680,319,361,0,1,1,ABMrun_3.1.23_b,5,900
170,174,132,223,669,325,344,0,1,1,ABMrun_3.1.23_b,5,892
171,182,138,232,653,336,317,0,1,1,ABMrun_3.1.23_b,5,885
172,173,129,225,671,354,317,0,1,1,ABMrun_3.1.23_b,5,896
173,168,132,224,669,353,316,0,1,1,ABMrun_3.1.23_b,5,893
174,167,121,224,667,347,320,0,1,1,ABMrun_3.1.23_b,5,891
175,169,134,217,695,362,333,0,1,1,ABMrun_3.1.23_b,5,912
176,160,135,205,726,374,352,0,1,1,ABMrun_3.1.23_b,5,931
177,175,130,225,667,349,318,0,1,1,ABMrun_3.1.23_b,5,892
178,184,145,232,640,319,321,0,1,1,ABMrun_3.1.23_b,5,872
179,177,142,229,658,323,335,0,1,1,ABMrun_3.1.23_b,5,887
180,173,142,224,668,322,346,0,1,1,ABMrun_3.1.23_b,5,892
181,183,137,231,644,317,327,0,1,1,ABMrun_3.1.23_b,5,875
182,170,133,222,667,331,336,0,1,1,ABMrun_3.1.23_b,5,889
183,171,139,221,678,336,342,0,1,1,ABMrun_3.1.23_b,5,899
184,174,121,226,670,351,319,0,1,1,ABMrun_3.1.23_b,5,896
185,177,132,223,664,356,308,0,1,1,ABMrun_3.1.23_b,5,887
186,176,133,218,681,351,330,0,1,1,ABMrun_3.1.23_b,5,899
187,171,131,226,663,343,320,0,1,1,ABMrun_3.1.23_b,5,889
188,177,140,224,666,341,325,0,1,1,ABMrun_3.1.23_b,5,890
189,163,125,218,680,336,344,0,1,1,ABMrun_3.1.23_b,5,898
190,172,139,226,662,332,330,0,1,1,ABMrun_3.1.23_b,5,888
191,180,141,229,656,327,329,0,1,1,ABMrun_3.1.23_b,5,885
192,183,138,236,641,333,308,0,1,1,ABMrun_3.1.23_b,5,877
193,170,131,229,650,338,312,0,1,1,ABMrun_3.1.23_b,5,879
194,178,134,226,665,340,325,0,1,1,ABMrun_3.1.23_b,5,891
195,171,125,227,651,337,314,0,1,1,ABMrun_3.1.23_b,5,878
196,175,135,226,664,336,328,0,1,1,ABMrun_3.1.23_b,5,890
197,169,125,227,661,328,333,0,1,1,ABMrun_3.1.23_b,5,888
198,177,137,221,681,334,347,0,1,1,ABMrun_3.1.23_b,5,902
199,177,142,230,653,299,354,0,1,1,ABMrun_3.1.23_b,5,883
200,175,144,224,669,311,358,0,1,1,ABMrun_3.1.23_b,5,893
201,156,129,203,723,341,382,0,1,1,ABMrun_3.1.23_b,5,926
202,178,134,228,660,320,340,0,1,1,ABMrun_3.1.23_b,5,888
203,176,134,226,659,325,334,0,1,1,ABMrun_3.1.23_b,5,885
204,166,133,223,673,310,363,0,1,1,ABMrun_3.1.23_b,5,896
205,183,139,231,650,293,357,0,1,1,ABMrun_3.1.23_b,5,881
206,171,139,225,668,312,356,0,1,1,ABMrun_3.1.23_b,5,893
207,171,129,227,658,324,334,0,1,1,ABMrun_3.1.23_b,5,885
208,170,130,225,663,336,327,0,1,1,ABMrun_3.1.23_b,5,888
209,174,129,223,669,350,319,0,1,1,ABMrun_3.1.23_b,5,892
210,177,129,228,659,344,315,0,1,1,ABMrun_3.1.23_b,5,887
211,174,137,225,668,356,312,0,1,1,ABMrun_3.1.23_b,5,893
212,169,133,219,673,359,314,0,1,1,ABMrun_3.1.23_b,5,892
213,176,129,225,662,344,318,0,1,1,ABMrun_3.1.23_b,5,887
214,168,128,222,685,353,332,0,1,1,ABMrun_3.1.23_b,5,907
215,172,133,226,661,340,321,0,1,1,ABMrun_3.1.23_b,5,887
216,181,130,230,652,335,317,0,1,1,ABMrun_3.1.23_b,5,882
217,181,133,230,642,330,312,0,1,1,ABMrun_3.1.23_b,5,872
218,182,131,227,655,343,312,0,1,1,ABMrun_3.1.23_b,5,882
219,171,136,219,686,337,349,0,1,1,ABMrun_3.1.23_b,5,905
220,176,137,223,674,330,344,0,1,1,ABMrun_3.1.23_b,5,897
221,179,142,229,658,321,337,0,1,1,ABMrun_3.1.23_b,5,887
222,174,135,222,675,340,335,0,1,1,ABMrun_3.1.23_b,5,897
223,175,133,223,671,351,320,0,1,1,ABMrun_3.1.23_b,5,894
224,180,133,222,663,363,300,0,1,1,ABMrun_3.1.23_b,5,885
225,175,131,226,660,361,299,0,1,1,ABMrun_3.1.23_b,5,886
226,165,136,207,718,370,348,0,1,1,ABMrun_3.1.23_b,5,925
227,171,130,216,680,349,331,0,1,1,ABMrun_3.1.23_b,5,896
228,169,128,217,691,374,317,0,1,1,ABMrun_3.1.23_b,5,908
229,170,141,224,668,329,339,0,1,1,ABMrun_3.1.23_b,5,892
230,174,129,227,664,332,332,0,1,1,ABMrun_3.1.23_b,5,891
231,173,133,224,667,334,333,0,1,1,ABMrun_3.1.23_b,5,891
232,164,121,219,681,351,330,0,1,1,ABMrun_3.1.23_b,5,900
233,174,142,225,663,338,325,0,1,1,ABMrun_3.1.23_b,5,888
234,172,137,227,666,334,332,0,1,1,ABMrun_3.1.23_b,5,893
235,176,130,226,665,326,339,0,1,1,ABMrun_3.1.23_b,5,891
236,173,141,223,667,323,344,0,1,1,ABMrun_3.1.23_b,5,890
237,168,134,223,674,317,357,0,1,1,ABMrun_3.1.23_b,5,897
238,177,142,216,680,312,368,0,1,1,ABMrun_3.1.23_b,5,896
239,182,145,225,672,309,363,0,1,1,ABMrun_3.1.23_b,5,897
240,182,132,232,649,299,350,0,1,1,ABMrun_3.1.23_b,5,881
241,167,129,228,656,305,351,0,1,1,ABMrun_3.1.23_b,5,884
242,177,138,229,660,306,354,0,1,1,ABMrun_3.1.23_b,5,889
243,182,143,233,643,307,336,0,1,1,ABMrun_3.1.23_b,5,876
244,175,146,225,660,318,342,0,1,1,ABMrun_3.1.23_b,5,885
245,176,143,226,661,319,342,0,1,1,ABMrun_3.1.23_b,5,887
246,175,134,229,657,320,337,0,1,1,ABMrun_3.1.23_b,5,886
247,174,137,224,672,327,345,0,1,1,ABMrun_3.1.23_b,5,896
248,182,135,231,638,321,317,0,1,1,ABMrun_3.1.23_b,5,869
249,181,136,225,666,343,323,0,1,1,ABMrun_3.1.23_b,5,891
250,182,138,236,641,333,308,0,1,1,ABMrun_3.1.23_b,5,877
251,160,134,208,716,380,336,0,1,1,ABMrun_3.1.23_b,5,924
252,166,128,215,686,355,331,0,1,1,ABMrun_3.1.23_b,5,901
253,177,139,225,668,341,327,0,1,1,ABMrun_3.1.23_b,5,893
254,177,140,228,657,340,317,0,1,1,ABMrun_3.1.23_b,5,885
255,170,134,219,689,354,335,0,1,1,ABMrun_3.1.23_b,5,908
256,175,132,223,664,345,319,0,1,1,ABMrun_3.1.23_b,5,887
257,174,134,226,662,340,322,0,1,1,ABMrun_3.1.23_b,5,888
258,173,131,227,660,343,317,0,1,1,ABMrun_3.1.23_b,5,887
259,177,137,224,663,352,311,0,1,1,ABMrun_3.1.23_b,5,887
260,182,136,233,643,338,305,0,1,1,ABMrun_3.1.23_b,5,876
261,174,130,231,646,327,319,0,1,1,ABMrun_3.1.23_b,5,877
262,168,131,217,690,355,335,0,1,1,ABMrun_3.1.23_b,5,907
263,168,134,223,679,345,334,0,1,1,ABMrun_3.1.23_b,5,902
264,158,129,215,687,339,348,0,1,1,ABMrun_3.1.23_b,5,902
265,165,132,211,700,328,372,0,1,1,ABMrun_3.1.23_b,5,911
266,165,131,208,708,346,362,0,1,1,ABMrun_3.1.23_b,5,916
267,176,140,222,683,341,342,0,1,1,ABMrun_3.1.23_b,5,905
268,177,141,226,657,331,326,0,1,1,ABMrun_3.1.23_b,5,883
269,177,138,228,653,329,324,0,1,1,ABMrun_3.1.23_b,5,881
270,176,134,230,659,334,325,0,1,1,ABMrun_3.1.23_b,5,889
271,179,129,226,663,334,329,0,1,1,ABMrun_3.1.23_b,5,889
272,172,135,224,675,323,352,0,1,1,ABMrun_3.1.23_b,5,899
273,175,136,223,669,324,345,0,1,1,ABMrun_3.1.23_b,5,892
274,174,144,224,661,328,333,0,1,1,ABMrun_3.1.23_b,5,885
275,172,127,218,684,360,324,0,1,1,ABMrun_3.1.23_b,5,902
276,159,126,203,723,379,344,0,1,1,ABMrun_3.1.23_b,5,926
277,173,130,221,683,351,332,0,1,1,ABMrun_3.1.23_b,5,904
278,169,130,221,671,343,328,0,1,1,ABMrun_3.1.23_b,5,892
279,185,138,233,642,338,304,0,1,1,ABMrun_3.1.23_b,5,875
280,180,128,227,651,344,307,0,1,1,ABMrun_3.1.23_b,5,878
281,178,135,225,667,347,320,0,1,1,ABMrun_3.1.23_b,5,892
282,175,132,223,670,341,329,0,1,1,ABMrun_3.1.23_b,5,893
283,180,133,229,659,331,328,0,1,1,ABMrun_3.1.23_b,5,888
284,171,134,222,677,341,336,0,1,1,ABMrun_3.1.23_b,5,899
285,179,137,226,664,339,325,0,1,1,ABMrun_3.1.23_b,5,890
286,176,132,222,677,338,339,0,1,1,ABMrun_3.1.23_b,5,899
287,178,137,234,637,313,324,0,1,1,ABMrun_3.1.23_b,5,871
288,177,141,220,676,318,358,0,1,1,ABMrun_3.1.23_b,5,896
289,176,134,222,679,321,358,0,1,1,ABMrun_3.1.23_b,5,901
290,171,136,227,665,333,332,0,1,1,ABMrun_3.1.23_b,5,892
291,170,135,218,685,342,343,0,1,1,ABMrun_3.1.23_b,5,903
292,179,134,227,667,318,349,0,1,1,ABMrun_3.1.23_b,5,894
293,184,144,229,651,323,328,0,1,1,ABMrun_3.1.23_b,5,880
294,174,140,219,687,356,331,0,1,1,ABMrun_3.1.23_b,5,906
295,168,133,228,644,319,325,0,1,1,ABMrun_3.1.23_b,5,872
296,182,142,231,645,317,328,0,1,1,ABMrun_3.1.23_b,5,876
297,174,130,222,676,325,351,0,1,1,ABMrun_3.1.23_b,5,898
298,170,131,222,678,326,352,0,1,1,ABMrun_3.1.23_b,5,900
299,175,130,222,668,329,339,0,1,1,ABMrun_3.1.23_b,5,890
300,165,130,220,684,337,347,0,1,1,ABMrun_3.1.23_b,5,904
301,152,118,196,736,365,371,0,1,1,ABMrun_3.1.23_b,5,932
302,172,136,223,668,329,339,0,1,1,ABMrun_3.1.23_b,5,891
303,184,142,231,646,315,331,0,1,1,ABMrun_3.1.23_b,5,877
304,180,133,235,632,307,325,0,1,1,ABMrun_3.1.23_b,5,867
305,176,140,226,667,342,325,0,1,1,ABMrun_3.1.23_b,5,893
306,174,132,227,658,349,309,0,1,1,ABMrun_3.1.23_b,5,885
307,174,139,218,682,347,335,0,1,1,ABMrun_3.1.23_b,5,900
308,175,137,222,676,329,347,0,1,1,ABMrun_3.1.23_b,5,898
309,173,127,227,659,318,341,0,1,1,ABMrun_3.1.23_b,5,886
310,180,139,224,664,313,351,0,1,1,ABMrun_3.1.23_b,5,888
311,177,134,231,638,304,334,0,1,1,ABMrun_3.1.23_b,5,869
312,176,146,221,673,314,359,0,1,1,ABMrun_3.1.23_b,5,894
313,168,138,224,670,307,363,0,1,1,ABMrun_3.1.23_b,5,894
314,169,132,221,679,319,360,0,1,1,ABMrun_3.1.23_b,5,900
315,169,136,222,685,318,367,0,1,1,ABMrun_3.1.23_b,5,907
316,174,135,223,676,323,353,0,1,1,ABMrun_3.1.23_b,5,899
317,184,147,233,654,298,356,0,1,1,ABMrun_3.1.23_b,5,887
318,183,138,235,638,292,346,0,1,1,ABMrun_3.1.23_b,5,873
319,168,124,228,655,299,356,0,1,1,ABMrun_3.1.23_b,5,883
320,177,141,225,667,323,344,0,1,1,ABMrun_3.1.23_b,5,892
321,180,136,218,686,326,360,0,1,1,ABMrun_3.1.23_b,5,904
322,176,145,222,665,307,358,0,1,1,ABMrun_3.1.23_b,5,887
323,169,139,223,670,321,349,0,1,1,ABMrun_3.1.23_b,5,893
324,169,135,222,679,336,343,0,1,1,ABMrun_3.1.23_b,5,901
325,173,133,225,668,347,321,0,1,1,ABMrun_3.1.23_b,5,893
326,164,137,209,715,377,338,0,1,1,ABMrun_3.1.23_b,5,924
327,178,143,225,671,346,325,0,1,1,ABMrun_3.1.23_b,5,896
328,170,135,221,676,334,342,0,1,1,ABMrun_3.1.23_b,5,897
329,190,146,229,652,316,336,0,1,1,ABMrun_3.1.23_b,5,881
330,173,130,225,674,321,353,0,1,1,ABMrun_3.1.23_b,5,899
331,171,135,226,654,309,345,0,1,1,ABMrun_3.1.23_b,5,880
332,174,135,227,660,330,330,0,1,1,ABMrun_3.1.23_b,5,887
333,176,141,227,658,335,323,0,1,1,ABMrun_3.1.23_b,5,885
334,174,130,228,660,340,320,0,1,1,ABMrun_3.1.23_b,5,888
335,173,141,233,640,323,317,0,1,1,ABMrun_3.1.23_b,5,873
336,175,141,225,664,344,320,0,1,1,ABMrun_3.1.23_b,5,889
337,172,132,217,689,345,344,0,1,1,ABMrun_3.1.23_b,5,906
338,175,139,222,678,325,353,0,1,1,ABMrun_3.1.23_b,5,900
339,174,139,222,670,321,349,0,1,1,ABMrun_3.1.23_b,5,892
340,185,136,239,619,307,312,0,1,1,ABMrun_3.1.23_b,5,858
341,184,138,232,644,318,326,0,1,1,ABMrun_3.1.23_b,5,876
342,175,128,221,676,355,321,0,1,1,ABMrun_3.1.23_b,5,897
343,177,133,225,668,355,313,0,1,1,ABMrun_3.1.23_b,5,893
344,178,139,225,668,347,321,0,1,1,ABMrun_3.1.23_b,5,893
345,176,132,227,663,333,330,0,1,1,ABMrun_3.1.23_b,5,890
346,181,140,230,655,330,325,0,1,1,ABMrun_3.1.23_b,5,885
347,167,138,217,695,341,354,0,1,1,ABMrun_3.1.23_b,5,912
348,175,135,221,673,344,329,0,1,1,ABMrun_3.1.23_b,5,894
349,176,137,224,665,338,327,0,1,1,ABMrun_3.1.23_b,5,889
350,188,136,233,643,336,307,0,1,1,ABMrun_3.1.23_b,5,876
1,20,17,25,601,299,302,0,2,1,ABMrun_3.1.23_b,5,626
2,84,73,112,871,448,423,0,2,1,ABMrun_3.1.23_b,5,983
3,139,119,179,778,388,390,0,2,1,ABMrun_3.1.23_b,5,957
4,165,128,215,703,353,350,0,2,1,ABMrun_3.1.23_b,5,918
5,177,132,229,654,338,316,0,2,1,ABMrun_3.1.23_b,5,883
6,181,140,232,647,338,309,0,2,1,ABMrun_3.1.23_b,5,879
7,183,139,232,649,318,331,0,2,1,ABMrun_3.1.23_b,5,881
8,181,142,230,645,318,327,0,2,1,ABMrun_3.1.23_b,5,875
9,190,140,237,634,318,316,0,2,1,ABMrun_3.1.23_b,5,871
10,180,135,233,644,315,329,0,2,1,ABMrun_3.1.23_b,5,877
11,182,138,224,673,340,333,0,2,1,ABMrun_3.1.23_b,5,897
12,175,138,229,672,350,322,0,2,1,ABMrun_3.1.23_b,5,901
13,177,139,227,664,335,329,0,2,1,ABMrun_3.1.23_b,5,891
14,170,140,225,679,332,347,0,2,1,ABMrun_3.1.23_b,5,904
15,172,133,231,661,318,343,0,2,1,ABMrun_3.1.23_b,5,892
16,168,130,224,675,317,358,0,2,1,ABMrun_3.1.23_b,5,899
17,182,140,227,664,314,350,0,2,1,ABMrun_3.1.23_b,5,891
18,172,125,219,684,326,358,0,2,1,ABMrun_3.1.23_b,5,903
19,180,136,228,663,325,338,0,2,1,ABMrun_3.1.23_b,5,891
20,181,137,229,661,330,331,0,2,1,ABMrun_3.1.23_b,5,890
21,175,138,223,679,325,354,0,2,1,ABMrun_3.1.23_b,5,902
22,184,143,235,641,313,328,0,2,1,ABMrun_3.1.23_b,5,876
23,180,142,236,641,316,325,0,2,1,ABMrun_3.1.23_b,5,877
24,178,131,234,636,320,316,0,2,1,ABMrun_3.1.23_b,5,870
25,174,135,226,672,331,341,0,2,1,ABMrun_3.1.23_b,5,898
26,166,127,205,720,369,351,0,2,1,ABMrun_3.1.23_b,5,925
27,170,129,222,679,338,341,0,2,1,ABMrun_3.1.23_b,5,901
28,184,142,231,643,316,327,0,2,1,ABMrun_3.1.23_b,5,874
29,176,140,227,668,340,328,0,2,1,ABMrun_3.1.23_b,5,895
30,179,142,230,662,342,320,0,2,1,ABMrun_3.1.23_b,5,892
31,172,129,226,662,340,322,0,2,1,ABMrun_3.1.23_b,5,888
32,184,135,232,654,333,321,0,2,1,ABMrun_3.1.23_b,5,886
33,175,138,229,659,336,323,0,2,1,ABMrun_3.1.23_b,5,888
34,175,144,229,667,349,318,0,2,1,ABMrun_3.1.23_b,5,896
35,176,134,222,677,353,324,0,2,1,ABMrun_3.1.23_b,5,899
36,182,142,229,663,335,328,0,2,1,ABMrun_3.1.23_b,5,892
37,180,139,223,671,333,338,0,2,1,ABMrun_3.1.23_b,5,894
38,192,137,235,637,312,325,0,2,1,ABMrun_3.1.23_b,5,872
39,184,147,240,620,316,304,0,2,1,ABMrun_3.1.23_b,5,860
40,185,138,233,646,337,309,0,2,1,ABMrun_3.1.23_b,5,879
41,171,132,235,637,324,313,0,2,1,ABMrun_3.1.23_b,5,872
42,186,134,234,650,327,323,0,2,1,ABMrun_3.1.23_b,5,884
43,182,131,230,663,330,333,0,2,1,ABMrun_3.1.23_b,5,893
44,181,144,229,650,344,306,0,2,1,ABMrun_3.1.23_b,5,879
45,184,138,230,660,352,308,0,2,1,ABMrun_3.1.23_b,5,890
46,177,135,227,665,346,319,0,2,1,ABMrun_3.1.23_b,5,892
47,179,147,228,659,316,343,0,2,1,ABMrun_3.1.23_b,5,887
48,173,139,225,661,320,341,0,2,1,ABMrun_3.1.23_b,5,886
49,176,139,230,657,306,351,0,2,1,ABMrun_3.1.23_b,5,887
50,192,141,239,625,273,352,0,2,1,ABMrun_3.1.23_b,5,864
51,169,138,216,701,317,384,0,2,1,ABMrun_3.1.23_b,5,917
52,178,138,228,665,306,359,0,2,1,ABMrun_3.1.23_b,5,893
53,177,134,229,664,303,361,0,2,1,ABMrun_3.1.23_b,5,893
54,185,149,228,661,310,351,0,2,1,ABMrun_3.1.23_b,5,889
55,179,136,234,640,301,339,0,2,1,ABMrun_3.1.23_b,5,874
56,189,137,233,654,315,339,0,2,1,ABMrun_3.1.23_b,5,887
57,169,136,224,663,337,326,0,2,1,ABMrun_3.1.23_b,5,887
58,173,135,224,678,352,326,0,2,1,ABMrun_3.1.23_b,5,902
59,175,134,222,674,341,333,0,2,1,ABMrun_3.1.23_b,5,896
60,185,141,235,642,334,308,0,2,1,ABMrun_3.1.23_b,5,877
61,175,136,230,653,347,306,0,2,1,ABMrun_3.1.23_b,5,883
62,180,129,232,644,327,317,0,2,1,ABMrun_3.1.23_b,5,876
63,180,131,231,658,332,326,0,2,1,ABMrun_3.1.23_b,5,889
64,182,141,227,660,315,345,0,2,1,ABMrun_3.1.23_b,5,887
65,182,145,237,639,277,362,0,2,1,ABMrun_3.1.23_b,5,876
66,181,156,231,659,304,355,0,2,1,ABMrun_3.1.23_b,5,890
67,178,131,229,651,327,324,0,2,1,ABMrun_3.1.23_b,5,880
68,177,140,224,669,328,341,0,2,1,ABMrun_3.1.23_b,5,893
69,173,143,225,664,331,333,0,2,1,ABMrun_3.1.23_b,5,889
70,180,137,231,648,320,328,0,2,1,ABMrun_3.1.23_b,5,879
71,176,134,230,646,316,330,0,2,1,ABMrun_3.1.23_b,5,876
72,180,134,231,656,316,340,0,2,1,ABMrun_3.1.23_b,5,887
73,181,138,228,665,314,351,0,2,1,ABMrun_3.1.23_b,5,893
74,174,137,223,677,323,354,0,2,1,ABMrun_3.1.23_b,5,900
75,184,136,228,658,316,342,0,2,1,ABMrun_3.1.23_b,5,886
76,168,135,215,699,344,355,0,2,1,ABMrun_3.1.23_b,5,914
77,184,141,227,661,334,327,0,2,1,ABMrun_3.1.23_b,5,888
78,183,141,229,663,335,328,0,2,1,ABMrun_3.1.23_b,5,892
79,181,140,227,656,322,334,0,2,1,ABMrun_3.1.23_b,5,883
80,184,143,231,649,333,316,0,2,1,ABMrun_3.1.23_b,5,880
81,181,139,230,656,325,331,0,2,1,ABMrun_3.1.23_b,5,886
82,180,136,230,651,331,320,0,2,1,ABMrun_3.1.23_b,5,881
83,176,140,229,660,334,326,0,2,1,ABMrun_3.1.23_b,5,889
84,178,145,222,662,324,338,0,2,1,ABMrun_3.1.23_b,5,884
85,173,131,226,657,335,322,0,2,1,ABMrun_3.1.23_b,5,883
86,176,133,224,668,345,323,0,2,1,ABMrun_3.1.23_b,5,892
87,177,137,227,663,338,325,0,2,1,ABMrun_3.1.23_b,5,890
88,182,142,234,643,337,306,0,2,1,ABMrun_3.1.23_b,5,877
89,177,138,230,657,352,305,0,2,1,ABMrun_3.1.23_b,5,887
90,180,129,230,661,329,332,0,2,1,ABMrun_3.1.23_b,5,891
91,185,139,230,654,317,337,0,2,1,ABMrun_3.1.23_b,5,884
92,180,136,227,656,303,353,0,2,1,ABMrun_3.1.23_b,5,883
93,178,142,232,649,290,359,0,2,1,ABMrun_3.1.23_b,5,881
94,186,141,234,643,300,343,0,2,1,ABMrun_3.1.23_b,5,877
95,185,138,235,642,308,334,0,2,1,ABMrun_3.1.23_b,5,877
96,180,141,224,670,330,340,0,2,1,ABMrun_3.1.23_b,5,894
97,177,140,226,670,330,340,0,2,1,ABMrun_3.1.23_b,5,896
98,176,137,228,668,337,331,0,2,1,ABMrun_3.1.23_b,5,896
99,175,142,227,664,325,339,0,2,1,ABMrun_3.1.23_b,5,891
100,162,133,214,663,336,327,0,2,1,ABMrun_3.1.23_b,5,877
101,146,122,188,694,346,348,0,2,1,ABMrun_3.1.23_b,5,882
102,159,127,196,625,316,309,0,2,1,ABMrun_3.1.23_b,5,821
103,153,111,195,595,321,274,0,2,1,ABMrun_3.1.23_b,5,790
104,147,114,186,581,297,284,0,2,1,ABMrun_3.1.23_b,5,767
105,150,116,186,550,287,263,0,2,1,ABMrun_3.1.23_b,5,736
106,134,104,172,546,287,259,0,2,1,ABMrun_3.1.23_b,5,718
107,122,104,159,543,282,261,0,2,1,ABMrun_3.1.23_b,5,702
108,127,103,163,491,246,245,0,2,1,ABMrun_3.1.23_b,5,654
109,118,100,156,476,238,238,0,2,1,ABMrun_3.1.23_b,5,632
110,65,56,82,453,240,213,0,2,1,ABMrun_3.1.23_b,5,535
111,67,56,87,369,189,180,0,2,1,ABMrun_3.1.23_b,5,456
112,63,54,84,333,162,171,0,2,1,ABMrun_3.1.23_b,5,417
113,70,56,87,292,140,152,0,2,1,ABMrun_3.1.23_b,5,379
114,68,52,80,264,128,136,0,2,1,ABMrun_3.1.23_b,5,344
115,64,58,81,262,126,136,0,2,1,ABMrun_3.1.23_b,5,343
116,57,47,75,229,114,115,0,2,1,ABMrun_3.1.23_b,5,304
117,57,44,74,210,108,102,0,2,1,ABMrun_3.1.23_b,5,284
118,55,42,73,207,109,98,0,2,1,ABMrun_3.1.23_b,5,280
119,55,44,71,210,107,103,0,2,1,ABMrun_3.1.23_b,5,281
120,55,39,71,205,107,98,0,2,1,ABMrun_3.1.23_b,5,276
121,58,43,73,203,108,95,0,2,1,ABMrun_3.1.23_b,5,276
122,59,48,74,219,110,109,0,2,1,ABMrun_3.1.23_b,5,293
123,59,44,75,222,107,115,0,2,1,ABMrun_3.1.23_b,5,297
124,56,41,72,212,104,108,0,2,1,ABMrun_3.1.23_b,5,284
125,56,43,71,199,91,108,0,2,1,ABMrun_3.1.23_b,5,270
126,56,46,74,219,110,109,0,2,1,ABMrun_3.1.23_b,5,293
127,54,43,77,231,113,118,0,2,1,ABMrun_3.1.23_b,5,308
128,55,46,72,213,102,111,0,2,1,ABMrun_3.1.23_b,5,285
129,63,48,74,220,105,115,0,2,1,ABMrun_3.1.23_b,5,294
130,59,50,74,226,108,118,0,2,1,ABMrun_3.1.23_b,5,300
131,59,49,74,225,109,116,0,2,1,ABMrun_3.1.23_b,5,299
132,52,45,73,209,98,111,0,2,1,ABMrun_3.1.23_b,5,282
133,64,49,77,222,106,116,0,2,1,ABMrun_3.1.23_b,5,299
134,57,46,78,239,122,117,0,2,1,ABMrun_3.1.23_b,5,317
135,59,44,72,206,99,107,0,2,1,ABMrun_3.1.23_b,5,278
136,58,42,71,202,105,97,0,2,1,ABMrun_3.1.23_b,5,273
137,51,39,66,192,99,93,0,2,1,ABMrun_3.1.23_b,5,258
138,54,40,68,187,90,97,0,2,1,ABMrun_3.1.23_b,5,255
139,54,38,67,181,89,92,0,2,1,ABMrun_3.1.23_b,5,248
140,55,42,68,185,91,94,0,2,1,ABMrun_3.1.23_b,5,253
141,55,41,69,185,87,98,0,2,1,ABMrun_3.1.23_b,5,254
142,54,41,69,192,91,101,0,2,1,ABMrun_3.1.23_b,5,261
143,52,39,67,181,84,97,0,2,1,ABMrun_3.1.23_b,5,248
144,54,44,65,177,85,92,0,2,1,ABMrun_3.1.23_b,5,242
145,51,37,68,182,91,91,0,2,1,ABMrun_3.1.23_b,5,250
146,55,39,70,195,92,103,0,2,1,ABMrun_3.1.23_b,5,265
147,55,42,71,199,100,99,0,2,1,ABMrun_3.1.23_b,5,270
148,59,45,74,202,111,91,0,2,1,ABMrun_3.1.23_b,5,276
149,57,45,72,204,119,85,0,2,1,ABMrun_3.1.23_b,5,276
150,58,40,72,202,113,89,0,2,1,ABMrun_3.1.23_b,5,274
151,118,73,163,247,134,113,17,2,1,ABMrun_3.1.23_b,5,410
152,150,92,186,328,172,156,5,2,1,ABMrun_3.1.23_b,5,514
153,156,110,198,405,207,198,2,2,1,ABMrun_3.1.23_b,5,603
154,150,112,199,483,246,237,0,2,1,ABMrun_3.1.23_b,5,682
155,156,122,206,517,255,262,0,2,1,ABMrun_3.1.23_b,5,723
156,156,122,207,555,273,282,0,2,1,ABMrun_3.1.23_b,5,762
157,172,130,217,570,282,288,0,2,1,ABMrun_3.1.23_b,5,787
158,170,129,225,578,285,293,0,2,1,ABMrun_3.1.23_b,5,803
159,181,138,233,594,294,300,0,2,1,ABMrun_3.1.23_b,5,827
160,184,138,234,637,315,322,0,2,1,ABMrun_3.1.23_b,5,871
161,176,133,228,663,317,346,0,2,1,ABMrun_3.1.23_b,5,891
162,178,146,227,660,315,345,0,2,1,ABMrun_3.1.23_b,5,887
163,181,139,232,659,316,343,0,2,1,ABMrun_3.1.23_b,5,891
164,173,125,223,669,337,332,0,2,1,ABMrun_3.1.23_b,5,892
165,169,135,216,689,345,344,12,2,1,ABMrun_3.1.23_b,5,905
166,182,145,230,653,323,330,5,2,1,ABMrun_3.1.23_b,5,883
167,178,143,230,652,316,336,3,2,1,ABMrun_3.1.23_b,5,882
168,188,140,235,640,300,340,1,2,1,ABMrun_3.1.23_b,5,875
169,177,137,226,666,317,349,1,2,1,ABMrun_3.1.23_b,5,892
170,171,138,227,668,317,351,0,2,1,ABMrun_3.1.23_b,5,895
171,172,131,226,666,335,331,0,2,1,ABMrun_3.1.23_b,5,892
172,177,128,224,665,353,312,0,2,1,ABMrun_3.1.23_b,5,889
173,169,124,227,659,366,293,0,2,1,ABMrun_3.1.23_b,5,886
174,177,132,226,664,356,308,0,2,1,ABMrun_3.1.23_b,5,890
175,166,145,218,687,353,334,0,2,1,ABMrun_3.1.23_b,5,905
176,159,132,199,733,373,360,0,2,1,ABMrun_3.1.23_b,5,932
177,177,140,228,659,319,340,0,2,1,ABMrun_3.1.23_b,5,887
178,172,136,228,655,321,334,0,2,1,ABMrun_3.1.23_b,5,883
179,184,140,228,652,327,325,0,2,1,ABMrun_3.1.23_b,5,880
180,169,129,224,670,342,328,0,2,1,ABMrun_3.1.23_b,5,894
181,168,130,219,682,357,325,7,2,1,ABMrun_3.1.23_b,5,901
182,173,127,224,664,342,322,6,2,1,ABMrun_3.1.23_b,5,888
183,181,144,227,663,337,326,5,2,1,ABMrun_3.1.23_b,5,890
184,173,134,222,672,335,337,1,2,1,ABMrun_3.1.23_b,5,894
185,175,136,219,677,327,350,1,2,1,ABMrun_3.1.23_b,5,896
186,178,136,225,675,350,325,0,2,1,ABMrun_3.1.23_b,5,900
187,177,131,228,658,348,310,0,2,1,ABMrun_3.1.23_b,5,886
188,176,140,228,659,351,308,0,2,1,ABMrun_3.1.23_b,5,887
189,177,137,225,670,345,325,0,2,1,ABMrun_3.1.23_b,5,895
190,174,139,225,666,326,340,0,2,1,ABMrun_3.1.23_b,5,891
191,178,140,231,634,302,332,0,2,1,ABMrun_3.1.23_b,5,865
192,173,142,228,660,338,322,0,2,1,ABMrun_3.1.23_b,5,888
193,175,128,220,679,365,314,0,2,1,ABMrun_3.1.23_b,5,899
194,189,141,230,654,372,282,0,2,1,ABMrun_3.1.23_b,5,884
195,171,135,210,714,388,326,11,2,1,ABMrun_3.1.23_b,5,924
196,177,136,225,665,357,308,6,2,1,ABMrun_3.1.23_b,5,890
197,176,142,227,662,353,309,4,2,1,ABMrun_3.1.23_b,5,889
198,172,137,218,685,364,321,1,2,1,ABMrun_3.1.23_b,5,903
199,164,127,211,705,361,344,1,2,1,ABMrun_3.1.23_b,5,916
200,167,134,221,674,345,329,0,2,1,ABMrun_3.1.23_b,5,895
201,169,127,216,695,350,345,0,2,1,ABMrun_3.1.23_b,5,911
202,182,137,232,637,300,337,0,2,1,ABMrun_3.1.23_b,5,869
203,176,134,225,674,328,346,0,2,1,ABMrun_3.1.23_b,5,899
204,170,138,226,663,324,339,0,2,1,ABMrun_3.1.23_b,5,889
205,179,136,226,664,323,341,0,2,1,ABMrun_3.1.23_b,5,890
206,177,145,221,674,336,338,0,2,1,ABMrun_3.1.23_b,5,895
207,174,134,228,667,344,323,0,2,1,ABMrun_3.1.23_b,5,895
208,173,138,221,683,334,349,0,2,1,ABMrun_3.1.23_b,5,904
209,178,142,221,678,334,344,0,2,1,ABMrun_3.1.23_b,5,899
210,175,136,225,668,314,354,0,2,1,ABMrun_3.1.23_b,5,893
211,168,134,222,675,332,343,0,2,1,ABMrun_3.1.23_b,5,897
212,169,127,217,689,342,347,0,2,1,ABMrun_3.1.23_b,5,906
213,174,139,224,670,328,342,0,2,1,ABMrun_3.1.23_b,5,894
214,168,133,222,672,326,346,0,2,1,ABMrun_3.1.23_b,5,894
215,182,139,229,653,328,325,0,2,1,ABMrun_3.1.23_b,5,882
216,172,132,217,690,371,319,0,2,1,ABMrun_3.1.23_b,5,907
217,182,141,226,661,349,312,0,2,1,ABMrun_3.1.23_b,5,887
218,174,137,223,667,337,330,0,2,1,ABMrun_3.1.23_b,5,890
219,179,135,229,655,331,324,0,2,1,ABMrun_3.1.23_b,5,884
220,173,133,223,672,338,334,0,2,1,ABMrun_3.1.23_b,5,895
221,165,134,212,700,344,356,0,2,1,ABMrun_3.1.23_b,5,912
222,171,135,221,678,315,363,0,2,1,ABMrun_3.1.23_b,5,899
223,176,137,220,690,325,365,0,2,1,ABMrun_3.1.23_b,5,910
224,176,132,227,650,313,337,0,2,1,ABMrun_3.1.23_b,5,877
225,177,142,229,651,325,326,0,2,1,ABMrun_3.1.23_b,5,880
226,168,140,216,700,355,345,0,2,1,ABMrun_3.1.23_b,5,916
227,181,144,234,638,314,324,0,2,1,ABMrun_3.1.23_b,5,872
228,185,145,234,641,326,315,0,2,1,ABMrun_3.1.23_b,5,875
229,181,136,227,659,320,339,0,2,1,ABMrun_3.1.23_b,5,886
230,179,146,231,641,314,327,0,2,1,ABMrun_3.1.23_b,5,872
231,175,144,225,670,309,361,0,2,1,ABMrun_3.1.23_b,5,895
232,173,136,229,650,312,338,0,2,1,ABMrun_3.1.23_b,5,879
233,178,135,231,643,334,309,0,2,1,ABMrun_3.1.23_b,5,874
234,177,128,230,642,353,289,0,2,1,ABMrun_3.1.23_b,5,872
235,176,137,227,666,343,323,0,2,1,ABMrun_3.1.23_b,5,893
236,171,127,227,654,339,315,0,2,1,ABMrun_3.1.23_b,5,881
237,178,126,228,658,337,321,0,2,1,ABMrun_3.1.23_b,5,886
238,178,134,229,655,330,325,0,2,1,ABMrun_3.1.23_b,5,884
239,172,136,223,678,326,352,0,2,1,ABMrun_3.1.23_b,5,901
240,178,139,224,662,324,338,0,2,1,ABMrun_3.1.23_b,5,886
241,175,135,228,666,318,348,0,2,1,ABMrun_3.1.23_b,5,894
242,167,136,218,686,330,356,0,2,1,ABMrun_3.1.23_b,5,904
243,175,139,225,672,328,344,0,2,1,ABMrun_3.1.23_b,5,897
244,170,134,224,669,328,341,0,2,1,ABMrun_3.1.23_b,5,893
245,173,134,224,677,333,344,0,2,1,ABMrun_3.1.23_b,5,901
246,170,134,220,681,344,337,0,2,1,ABMrun_3.1.23_b,5,901
247,184,145,232,651,340,311,0,2,1,ABMrun_3.1.23_b,5,883
248,176,138,225,665,336,329,0,2,1,ABMrun_3.1.23_b,5,890
249,167,132,220,677,331,346,0,2,1,ABMrun_3.1.23_b,5,897
250,179,145,219,685,355,330,0,2,1,ABMrun_3.1.23_b,5,904
251,164,136,199,739,372,367,0,2,1,ABMrun_3.1.23_b,5,938
252,173,140,225,667,321,346,0,2,1,ABMrun_3.1.23_b,5,892
253,181,148,229,656,314,342,0,2,1,ABMrun_3.1.23_b,5,885
254,171,140,225,662,322,340,0,2,1,ABMrun_3.1.23_b,5,887
255,178,136,229,648,336,312,0,2,1,ABMrun_3.1.23_b,5,877
256,180,146,226,663,352,311,0,2,1,ABMrun_3.1.23_b,5,889
257,173,134,217,690,370,320,0,2,1,ABMrun_3.1.23_b,5,907
258,171,133,217,686,370,316,0,2,1,ABMrun_3.1.23_b,5,903
259,170,133,220,674,356,318,0,2,1,ABMrun_3.1.23_b,5,894
260,181,141,227,663,337,326,0,2,1,ABMrun_3.1.23_b,5,890
261,180,146,226,661,326,335,0,2,1,ABMrun_3.1.23_b,5,887
262,168,132,218,682,334,348,0,2,1,ABMrun_3.1.23_b,5,900
263,161,128,211,700,341,359,0,2,1,ABMrun_3.1.23_b,5,911
264,181,138,232,644,315,329,0,2,1,ABMrun_3.1.23_b,5,876
265,181,147,231,647,307,340,0,2,1,ABMrun_3.1.23_b,5,878
266,182,138,233,641,298,343,0,2,1,ABMrun_3.1.23_b,5,874
267,175,132,229,654,306,348,0,2,1,ABMrun_3.1.23_b,5,883
268,175,135,226,661,311,350,0,2,1,ABMrun_3.1.23_b,5,887
269,178,144,222,677,320,357,0,2,1,ABMrun_3.1.23_b,5,899
270,177,127,227,664,320,344,0,2,1,ABMrun_3.1.23_b,5,891
271,180,147,222,670,328,342,0,2,1,ABMrun_3.1.23_b,5,892
272,180,134,223,674,345,329,0,2,1,ABMrun_3.1.23_b,5,897
273,180,138,233,644,327,317,0,2,1,ABMrun_3.1.23_b,5,877
274,170,131,224,671,335,336,0,2,1,ABMrun_3.1.23_b,5,895
275,182,135,227,658,324,334,0,2,1,ABMrun_3.1.23_b,5,885
276,154,128,203,719,353,366,0,2,1,ABMrun_3.1.23_b,5,922
277,166,126,218,684,332,352,0,2,1,ABMrun_3.1.23_b,5,902
278,183,141,232,644,315,329,0,2,1,ABMrun_3.1.23_b,5,876
279,171,136,224,665,317,348,0,2,1,ABMrun_3.1.23_b,5,889
280,166,130,218,685,329,356,0,2,1,ABMrun_3.1.23_b,5,903
281,169,139,220,677,327,350,0,2,1,ABMrun_3.1.23_b,5,897
282,181,133,230,652,322,330,0,2,1,ABMrun_3.1.23_b,5,882
283,177,139,226,666,327,339,0,2,1,ABMrun_3.1.23_b,5,892
284,173,136,223,671,317,354,0,2,1,ABMrun_3.1.23_b,5,894
285,178,143,230,657,317,340,0,2,1,ABMrun_3.1.23_b,5,887
286,179,143,227,661,340,321,0,2,1,ABMrun_3.1.23_b,5,888
287,169,126,223,671,332,339,0,2,1,ABMrun_3.1.23_b,5,894
288,176,133,225,665,344,321,0,2,1,ABMrun_3.1.23_b,5,890
289,175,131,227,657,341,316,0,2,1,ABMrun_3.1.23_b,5,884
290,172,133,221,670,339,331,0,2,1,ABMrun_3.1.23_b,5,891
291,173,133,223,677,330,347,0,2,1,ABMrun_3.1.23_b,5,900
292,164,123,220,685,337,348,0,2,1,ABMrun_3.1.23_b,5,905
293,173,135,219,679,332,347,0,2,1,ABMrun_3.1.23_b,5,898
294,178,133,225,671,339,332,0,2,1,ABMrun_3.1.23_b,5,896
295,180,132,229,654,324,330,0,2,1,ABMrun_3.1.23_b,5,883
296,164,129,220,682,340,342,0,2,1,ABMrun_3.1.23_b,5,902
297,174,130,225,664,343,321,0,2,1,ABMrun_3.1.23_b,5,889
298,168,134,217,685,354,331,0,2,1,ABMrun_3.1.23_b,5,902
299,173,133,228,655,339,316,0,2,1,ABMrun_3.1.23_b,5,883
300,184,132,232,651,338,313,0,2,1,ABMrun_3.1.23_b,5,883
301,162,132,214,703,347,356,0,2,1,ABMrun_3.1.23_b,5,917
302,178,135,228,657,325,332,0,2,1,ABMrun_3.1.23_b,5,885
303,169,138,220,683,356,327,0,2,1,ABMrun_3.1.23_b,5,903
304,172,130,220,676,349,327,0,2,1,ABMrun_3.1.23_b,5,896
305,178,133,225,662,351,311,0,2,1,ABMrun_3.1.23_b,5,887
306,166,124,220,680,344,336,0,2,1,ABMrun_3.1.23_b,5,900
307,163,125,211,702,348,354,0,2,1,ABMrun_3.1.23_b,5,913
308,177,136,225,666,340,326,0,2,1,ABMrun_3.1.23_b,5,891
309,175,133,225,670,346,324,0,2,1,ABMrun_3.1.23_b,5,895
310,177,136,223,678,345,333,0,2,1,ABMrun_3.1.23_b,5,901
311,175,137,224,675,327,348,0,2,1,ABMrun_3.1.23_b,5,899
312,181,141,233,647,304,343,0,2,1,ABMrun_3.1.23_b,5,880
313,177,132,230,654,325,329,0,2,1,ABMrun_3.1.23_b,5,884
314,178,149,225,661,331,330,0,2,1,ABMrun_3.1.23_b,5,886
315,182,135,229,657,331,326,0,2,1,ABMrun_3.1.23_b,5,886
316,179,134,230,645,330,315,0,2,1,ABMrun_3.1.23_b,5,875
317,181,129,229,654,341,313,0,2,1,ABMrun_3.1.23_b,5,883
318,175,131,225,670,351,319,0,2,1,ABMrun_3.1.23_b,5,895
319,175,126,222,667,335,332,0,2,1,ABMrun_3.1.23_b,5,889
320,184,137,231,640,323,317,0,2,1,ABMrun_3.1.23_b,5,871
321,185,138,229,646,335,311,0,2,1,ABMrun_3.1.23_b,5,875
322,169,127,224,662,330,332,0,2,1,ABMrun_3.1.23_b,5,886
323,178,132,226,669,335,334,0,2,1,ABMrun_3.1.23_b,5,895
324,170,131,225,674,325,349,0,2,1,ABMrun_3.1.23_b,5,899
325,176,132,226,664,309,355,0,2,1,ABMrun_3.1.23_b,5,890
326,164,128,209,708,329,379,0,2,1,ABMrun_3.1.23_b,5,917
327,171,137,227,664,324,340,0,2,1,ABMrun_3.1.23_b,5,891
328,176,140,223,665,324,341,0,2,1,ABMrun_3.1.23_b,5,888
329,180,137,232,651,337,314,0,2,1,ABMrun_3.1.23_b,5,883
330,182,138,227,659,344,315,0,2,1,ABMrun_3.1.23_b,5,886
331,182,136,222,676,353,323,0,2,1,ABMrun_3.1.23_b,5,898
332,170,134,223,673,350,323,0,2,1,ABMrun_3.1.23_b,5,896
333,182,143,229,653,343,310,0,2,1,ABMrun_3.1.23_b,5,882
334,186,142,231,648,328,320,0,2,1,ABMrun_3.1.23_b,5,879
335,181,136,233,647,314,333,0,2,1,ABMrun_3.1.23_b,5,880
336,169,139,227,662,320,342,0,2,1,ABMrun_3.1.23_b,5,889
337,180,139,225,666,326,340,0,2,1,ABMrun_3.1.23_b,5,891
338,169,130,221,672,334,338,0,2,1,ABMrun_3.1.23_b,5,893
339,184,144,226,660,327,333,0,2,1,ABMrun_3.1.23_b,5,886
340,172,136,220,675,338,337,0,2,1,ABMrun_3.1.23_b,5,895
341,172,138,221,675,329,346,0,2,1,ABMrun_3.1.23_b,5,896
342,174,137,225,665,326,339,0,2,1,ABMrun_3.1.23_b,5,890
343,176,141,229,662,317,345,0,2,1,ABMrun_3.1.23_b,5,891
344,179,139,230,652,317,335,0,2,1,ABMrun_3.1.23_b,5,882
345,184,144,225,675,320,355,0,2,1,ABMrun_3.1.23_b,5,900
346,176,133,226,664,332,332,0,2,1,ABMrun_3.1.23_b,5,890
347,174,141,224,667,329,338,0,2,1,ABMrun_3.1.23_b,5,891
348,173,137,225,656,338,318,0,2,1,ABMrun_3.1.23_b,5,881
349,182,139,230,653,339,314,0,2,1,ABMrun_3.1.23_b,5,883
350,175,129,231,649,344,305,0,2,1,ABMrun_3.1.23_b,5,880
1,14,12,18,641,293,348,0,3,1,ABMrun_3.1.23_b,5,659
2,81,75,101,888,437,451,0,3,1,ABMrun_3.1.23_b,5,989
3,134,117,176,781,395,386,0,3,1,ABMrun_3.1.23_b,5,957
4,165,124,216,701,367,334,0,3,1,ABMrun_3.1.23_b,5,917
5,183,141,230,657,354,303,0,3,1,ABMrun_3.1.23_b,5,887
6,186,145,239,627,326,301,0,3,1,ABMrun_3.1.23_b,5,866
7,173,136,229,658,340,318,0,3,1,ABMrun_3.1.23_b,5,887
8,180,141,232,650,325,325,0,3,1,ABMrun_3.1.23_b,5,882
9,170,131,221,689,356,333,0,3,1,ABMrun_3.1.23_b,5,910
10,167,122,223,682,351,331,0,3,1,ABMrun_3.1.23_b,5,905
11,177,141,224,672,327,345,0,3,1,ABMrun_3.1.23_b,5,896
12,171,127,221,679,337,342,0,3,1,ABMrun_3.1.23_b,5,900
13,169,132,220,685,340,345,0,3,1,ABMrun_3.1.23_b,5,905
14,176,136,225,672,338,334,0,3,1,ABMrun_3.1.23_b,5,897
15,185,140,234,657,318,339,0,3,1,ABMrun_3.1.23_b,5,891
16,177,141,220,680,341,339,0,3,1,ABMrun_3.1.23_b,5,900
17,174,130,229,663,338,325,0,3,1,ABMrun_3.1.23_b,5,892
18,178,134,231,655,337,318,0,3,1,ABMrun_3.1.23_b,5,886
19,176,130,228,664,333,331,0,3,1,ABMrun_3.1.23_b,5,892
20,170,129,227,667,331,336,0,3,1,ABMrun_3.1.23_b,5,894
21,166,131,228,656,331,325,0,3,1,ABMrun_3.1.23_b,5,884
22,178,139,228,657,327,330,0,3,1,ABMrun_3.1.23_b,5,885
23,183,130,244,606,304,302,0,3,1,ABMrun_3.1.23_b,5,850
24,184,142,237,630,323,307,0,3,1,ABMrun_3.1.23_b,5,867
25,179,132,229,657,336,321,0,3,1,ABMrun_3.1.23_b,5,886
26,160,122,213,710,355,355,0,3,1,ABMrun_3.1.23_b,5,923
27,172,139,220,682,350,332,0,3,1,ABMrun_3.1.23_b,5,902
28,183,135,231,648,345,303,0,3,1,ABMrun_3.1.23_b,5,879
29,183,137,230,649,330,319,0,3,1,ABMrun_3.1.23_b,5,879
30,173,124,232,643,337,306,0,3,1,ABMrun_3.1.23_b,5,875
31,179,138,234,649,348,301,0,3,1,ABMrun_3.1.23_b,5,883
32,172,127,224,669,329,340,0,3,1,ABMrun_3.1.23_b,5,893
33,185,143,229,651,307,344,0,3,1,ABMrun_3.1.23_b,5,880
34,175,137,228,665,307,358,0,3,1,ABMrun_3.1.23_b,5,893
35,179,133,227,663,308,355,0,3,1,ABMrun_3.1.23_b,5,890
36,173,136,228,667,317,350,0,3,1,ABMrun_3.1.23_b,5,895
37,184,135,238,627,296,331,0,3,1,ABMrun_3.1.23_b,5,865
38,184,148,237,628,299,329,0,3,1,ABMrun_3.1.23_b,5,865
39,183,143,232,648,308,340,0,3,1,ABMrun_3.1.23_b,5,880
40,171,135,232,654,318,336,0,3,1,ABMrun_3.1.23_b,5,886
41,172,126,229,655,315,340,0,3,1,ABMrun_3.1.23_b,5,884
42,176,144,227,668,325,343,0,3,1,ABMrun_3.1.23_b,5,895
43,170,140,220,682,351,331,0,3,1,ABMrun_3.1.23_b,5,902
44,177,140,226,674,351,323,0,3,1,ABMrun_3.1.23_b,5,900
45,174,133,227,667,365,302,0,3,1,ABMrun_3.1.23_b,5,894
46,177,130,224,666,357,309,0,3,1,ABMrun_3.1.23_b,5,890
47,183,129,231,658,342,316,0,3,1,ABMrun_3.1.23_b,5,889
48,174,135,236,634,312,322,0,3,1,ABMrun_3.1.23_b,5,870
49,184,140,233,651,323,328,0,3,1,ABMrun_3.1.23_b,5,884
50,178,144,231,646,327,319,0,3,1,ABMrun_3.1.23_b,5,877
51,166,131,217,705,365,340,0,3,1,ABMrun_3.1.23_b,5,922
52,179,138,234,652,327,325,0,3,1,ABMrun_3.1.23_b,5,886
53,184,138,234,634,335,299,0,3,1,ABMrun_3.1.23_b,5,868
54,170,139,230,655,360,295,0,3,1,ABMrun_3.1.23_b,5,885
55,177,129,232,646,357,289,0,3,1,ABMrun_3.1.23_b,5,878
56,180,141,232,649,347,302,0,3,1,ABMrun_3.1.23_b,5,881
57,168,131,228,660,343,317,0,3,1,ABMrun_3.1.23_b,5,888
58,180,145,226,663,338,325,0,3,1,ABMrun_3.1.23_b,5,889
59,175,134,225,665,337,328,0,3,1,ABMrun_3.1.23_b,5,890
60,181,143,227,664,334,330,0,3,1,ABMrun_3.1.23_b,5,891
61,181,144,226,665,313,352,0,3,1,ABMrun_3.1.23_b,5,891
62,179,141,230,659,321,338,0,3,1,ABMrun_3.1.23_b,5,889
63,178,140,230,654,308,346,0,3,1,ABMrun_3.1.23_b,5,884
64,177,134,230,657,327,330,0,3,1,ABMrun_3.1.23_b,5,887
65,180,134,230,654,322,332,0,3,1,ABMrun_3.1.23_b,5,884
66,188,137,236,646,322,324,0,3,1,ABMrun_3.1.23_b,5,882
67,178,132,227,665,344,321,0,3,1,ABMrun_3.1.23_b,5,892
68,180,135,232,649,334,315,0,3,1,ABMrun_3.1.23_b,5,881
69,175,133,231,649,326,323,0,3,1,ABMrun_3.1.23_b,5,880
70,172,139,229,661,339,322,0,3,1,ABMrun_3.1.23_b,5,890
71,179,136,227,662,327,335,0,3,1,ABMrun_3.1.23_b,5,889
72,181,142,227,662,330,332,0,3,1,ABMrun_3.1.23_b,5,889
73,181,136,231,657,322,335,0,3,1,ABMrun_3.1.23_b,5,888
74,178,128,230,648,312,336,0,3,1,ABMrun_3.1.23_b,5,878
75,183,140,230,652,305,347,0,3,1,ABMrun_3.1.23_b,5,882
76,173,138,220,698,325,373,0,3,1,ABMrun_3.1.23_b,5,918
77,183,133,233,650,320,330,0,3,1,ABMrun_3.1.23_b,5,883
78,179,145,227,668,338,330,0,3,1,ABMrun_3.1.23_b,5,895
79,179,138,226,673,366,307,0,3,1,ABMrun_3.1.23_b,5,899
80,172,131,223,671,359,312,0,3,1,ABMrun_3.1.23_b,5,894
81,174,132,225,663,333,330,0,3,1,ABMrun_3.1.23_b,5,888
82,179,147,233,649,294,355,0,3,1,ABMrun_3.1.23_b,5,882
83,186,136,233,652,305,347,0,3,1,ABMrun_3.1.23_b,5,885
84,179,143,226,660,320,340,0,3,1,ABMrun_3.1.23_b,5,886
85,182,133,226,665,323,342,0,3,1,ABMrun_3.1.23_b,5,891
86,183,146,229,654,341,313,0,3,1,ABMrun_3.1.23_b,5,883
87,175,136,222,683,357,326,0,3,1,ABMrun_3.1.23_b,5,905
88,179,139,230,674,334,340,0,3,1,ABMrun_3.1.23_b,5,904
89,170,131,226,665,330,335,0,3,1,ABMrun_3.1.23_b,5,891
90,172,129,226,667,345,322,0,3,1,ABMrun_3.1.23_b,5,893
91,176,127,227,669,341,328,0,3,1,ABMrun_3.1.23_b,5,896
92,176,135,231,658,334,324,0,3,1,ABMrun_3.1.23_b,5,889
93,176,129,232,647,335,312,0,3,1,ABMrun_3.1.23_b,5,879
94,176,129,227,658,342,316,0,3,1,ABMrun_3.1.23_b,5,885
95,175,136,230,662,330,332,0,3,1,ABMrun_3.1.23_b,5,892
96,176,134,230,640,320,320,0,3,1,ABMrun_3.1.23_b,5,870
97,183,134,233,636,308,328,0,3,1,ABMrun_3.1.23_b,5,869
98,181,135,231,660,318,342,0,3,1,ABMrun_3.1.23_b,5,891
99,170,141,225,673,333,340,0,3,1,ABMrun_3.1.23_b,5,898
100,171,132,216,661,332,329,0,3,1,ABMrun_3.1.23_b,5,877
101,140,118,179,714,359,355,0,3,1,ABMrun_3.1.23_b,5,893
102,155,118,195,632,304,328,0,3,1,ABMrun_3.1.23_b,5,827
103,153,119,195,597,284,313,0,3,1,ABMrun_3.1.23_b,5,792
104,141,115,181,595,278,317,0,3,1,ABMrun_3.1.23_b,5,776
105,142,113,185,555,253,302,0,3,1,ABMrun_3.1.23_b,5,740
106,138,108,176,532,246,286,0,3,1,ABMrun_3.1.23_b,5,708
107,125,103,159,543,271,272,0,3,1,ABMrun_3.1.23_b,5,702
108,125,95,162,504,244,260,0,3,1,ABMrun_3.1.23_b,5,666
109,120,94,152,484,233,251,0,3,1,ABMrun_3.1.23_b,5,636
110,61,52,78,470,229,241,0,3,1,ABMrun_3.1.23_b,5,548
111,69,58,84,419,203,216,0,3,1,ABMrun_3.1.23_b,5,503
112,67,59,87,344,157,187,0,3,1,ABMrun_3.1.23_b,5,431
113,66,51,85,291,136,155,0,3,1,ABMrun_3.1.23_b,5,376
114,62,46,84,265,137,128,0,3,1,ABMrun_3.1.23_b,5,349
115,65,49,81,261,139,122,0,3,1,ABMrun_3.1.23_b,5,342
116,63,47,79,248,126,122,0,3,1,ABMrun_3.1.23_b,5,327
117,66,51,79,249,127,122,0,3,1,ABMrun_3.1.23_b,5,328
118,62,47,79,243,120,123,0,3,1,ABMrun_3.1.23_b,5,322
119,58,44,76,225,122,103,0,3,1,ABMrun_3.1.23_b,5,301
120,59,45,76,226,119,107,0,3,1,ABMrun_3.1.23_b,5,302
121,58,46,76,229,111,118,0,3,1,ABMrun_3.1.23_b,5,305
122,58,47,76,237,120,117,0,3,1,ABMrun_3.1.23_b,5,313
123,60,44,78,241,121,120,0,3,1,ABMrun_3.1.23_b,5,319
124,55,42,76,228,116,112,0,3,1,ABMrun_3.1.23_b,5,304
125,61,45,78,227,119,108,0,3,1,ABMrun_3.1.23_b,5,305
126,62,47,76,234,124,110,0,3,1,ABMrun_3.1.23_b,5,310
127,58,46,75,219,113,106,0,3,1,ABMrun_3.1.23_b,5,294
128,57,43,75,221,112,109,0,3,1,ABMrun_3.1.23_b,5,296
129,55,43,74,220,106,114,0,3,1,ABMrun_3.1.23_b,5,294
130,54,43,71,205,102,103,0,3,1,ABMrun_3.1.23_b,5,276
131,55,37,73,203,106,97,0,3,1,ABMrun_3.1.23_b,5,276
132,55,43,72,203,102,101,0,3,1,ABMrun_3.1.23_b,5,275
133,55,44,70,207,98,109,0,3,1,ABMrun_3.1.23_b,5,277
134,53,40,71,209,96,113,0,3,1,ABMrun_3.1.23_b,5,280
135,60,46,73,210,95,115,0,3,1,ABMrun_3.1.23_b,5,283
136,50,40,70,210,99,111,0,3,1,ABMrun_3.1.23_b,5,280
137,52,41,68,194,97,97,0,3,1,ABMrun_3.1.23_b,5,262
138,58,43,73,202,100,102,0,3,1,ABMrun_3.1.23_b,5,275
139,57,42,71,202,101,101,0,3,1,ABMrun_3.1.23_b,5,273
140,49,37,69,193,90,103,0,3,1,ABMrun_3.1.23_b,5,262
141,56,46,72,196,92,104,0,3,1,ABMrun_3.1.23_b,5,268
142,55,40,67,191,95,96,0,3,1,ABMrun_3.1.23_b,5,258
143,54,44,67,193,95,98,0,3,1,ABMrun_3.1.23_b,5,260
144,61,46,73,199,95,104,0,3,1,ABMrun_3.1.23_b,5,272
145,57,43,71,200,100,100,0,3,1,ABMrun_3.1.23_b,5,271
146,54,43,73,200,107,93,0,3,1,ABMrun_3.1.23_b,5,273
147,59,43,72,213,125,88,0,3,1,ABMrun_3.1.23_b,5,285
148,55,39,73,210,112,98,0,3,1,ABMrun_3.1.23_b,5,283
149,59,40,72,201,104,97,0,3,1,ABMrun_3.1.23_b,5,273
150,60,51,75,216,103,113,0,3,1,ABMrun_3.1.23_b,5,291
151,106,69,160,243,120,123,1,3,1,ABMrun_3.1.23_b,5,403
152,131,89,182,308,143,165,1,3,1,ABMrun_3.1.23_b,5,490
153,152,103,196,395,191,204,2,3,1,ABMrun_3.1.23_b,5,591
154,154,114,202,476,234,242,0,3,1,ABMrun_3.1.23_b,5,678
155,160,120,204,519,258,261,0,3,1,ABMrun_3.1.23_b,5,723
156,166,125,213,539,272,267,2,3,1,ABMrun_3.1.23_b,5,752
157,171,131,217,565,293,272,1,3,1,ABMrun_3.1.23_b,5,782
158,174,131,222,588,302,286,1,3,1,ABMrun_3.1.23_b,5,810
159,174,140,225,626,311,315,1,3,1,ABMrun_3.1.23_b,5,851
160,181,138,231,645,309,336,0,3,1,ABMrun_3.1.23_b,5,876
161,184,149,233,657,318,339,1,3,1,ABMrun_3.1.23_b,5,890
162,193,149,240,626,304,322,1,3,1,ABMrun_3.1.23_b,5,866
163,174,131,233,636,296,340,1,3,1,ABMrun_3.1.23_b,5,869
164,168,131,224,682,310,372,1,3,1,ABMrun_3.1.23_b,5,906
165,178,134,236,638,305,333,2,3,1,ABMrun_3.1.23_b,5,874
166,175,137,229,656,321,335,1,3,1,ABMrun_3.1.23_b,5,885
167,181,136,233,646,322,324,0,3,1,ABMrun_3.1.23_b,5,879
168,177,135,227,658,323,335,1,3,1,ABMrun_3.1.23_b,5,885
169,177,142,226,663,331,332,1,3,1,ABMrun_3.1.23_b,5,889
170,171,132,225,680,344,336,0,3,1,ABMrun_3.1.23_b,5,905
171,169,139,225,668,344,324,1,3,1,ABMrun_3.1.23_b,5,893
172,177,135,228,656,322,334,2,3,1,ABMrun_3.1.23_b,5,884
173,176,131,223,675,340,335,1,3,1,ABMrun_3.1.23_b,5,898
174,171,125,224,672,340,332,1,3,1,ABMrun_3.1.23_b,5,896
175,174,135,224,674,325,349,0,3,1,ABMrun_3.1.23_b,5,898
176,169,141,213,700,335,365,1,3,1,ABMrun_3.1.23_b,5,913
177,178,140,232,650,303,347,1,3,1,ABMrun_3.1.23_b,5,882
178,179,142,229,658,315,343,1,3,1,ABMrun_3.1.23_b,5,887
179,167,131,224,679,334,345,0,3,1,ABMrun_3.1.23_b,5,903
180,172,136,223,668,337,331,1,3,1,ABMrun_3.1.23_b,5,891
181,179,137,226,670,334,336,0,3,1,ABMrun_3.1.23_b,5,896
182,176,148,225,667,331,336,0,3,1,ABMrun_3.1.23_b,5,892
183,175,130,221,680,349,331,1,3,1,ABMrun_3.1.23_b,5,901
184,175,137,225,667,349,318,2,3,1,ABMrun_3.1.23_b,5,892
185,177,137,228,658,341,317,2,3,1,ABMrun_3.1.23_b,5,886
186,175,133,221,683,352,331,1,3,1,ABMrun_3.1.23_b,5,904
187,177,137,228,660,356,304,1,3,1,ABMrun_3.1.23_b,5,888
188,177,132,220,678,356,322,0,3,1,ABMrun_3.1.23_b,5,898
189,170,132,223,672,339,333,1,3,1,ABMrun_3.1.23_b,5,895
190,165,140,218,684,332,352,1,3,1,ABMrun_3.1.23_b,5,902
191,173,138,228,662,321,341,0,3,1,ABMrun_3.1.23_b,5,890
192,171,136,230,650,316,334,1,3,1,ABMrun_3.1.23_b,5,880
193,182,147,229,656,321,335,1,3,1,ABMrun_3.1.23_b,5,885
194,175,129,233,651,332,319,0,3,1,ABMrun_3.1.23_b,5,884
195,183,138,233,644,323,321,1,3,1,ABMrun_3.1.23_b,5,877
196,185,140,235,638,335,303,0,3,1,ABMrun_3.1.23_b,5,873
197,173,131,224,665,347,318,0,3,1,ABMrun_3.1.23_b,5,889
198,180,138,229,645,317,328,1,3,1,ABMrun_3.1.23_b,5,874
199,178,136,227,656,312,344,1,3,1,ABMrun_3.1.23_b,5,883
200,181,137,233,639,317,322,1,3,1,ABMrun_3.1.23_b,5,872
201,165,131,215,701,342,359,0,3,1,ABMrun_3.1.23_b,5,916
202,185,139,226,669,349,320,1,3,1,ABMrun_3.1.23_b,5,895
203,172,127,224,671,350,321,1,3,1,ABMrun_3.1.23_b,5,895
204,172,145,224,674,347,327,1,3,1,ABMrun_3.1.23_b,5,898
205,170,136,223,668,349,319,0,3,1,ABMrun_3.1.23_b,5,891
206,178,145,227,674,342,332,1,3,1,ABMrun_3.1.23_b,5,901
207,175,144,224,683,340,343,0,3,1,ABMrun_3.1.23_b,5,907
208,172,133,229,657,318,339,1,3,1,ABMrun_3.1.23_b,5,886
209,181,144,228,652,314,338,1,3,1,ABMrun_3.1.23_b,5,880
210,173,132,227,663,334,329,1,3,1,ABMrun_3.1.23_b,5,890
211,179,139,227,663,330,333,1,3,1,ABMrun_3.1.23_b,5,890
212,172,137,223,671,318,353,1,3,1,ABMrun_3.1.23_b,5,894
213,175,138,222,677,323,354,0,3,1,ABMrun_3.1.23_b,5,899
214,173,139,222,688,342,346,1,3,1,ABMrun_3.1.23_b,5,910
215,163,130,215,700,338,362,1,3,1,ABMrun_3.1.23_b,5,915
216,182,141,234,639,302,337,1,3,1,ABMrun_3.1.23_b,5,873
217,176,142,230,659,317,342,0,3,1,ABMrun_3.1.23_b,5,889
218,177,135,227,660,337,323,0,3,1,ABMrun_3.1.23_b,5,887
219,176,135,225,666,346,320,0,3,1,ABMrun_3.1.23_b,5,891
220,187,141,237,635,325,310,0,3,1,ABMrun_3.1.23_b,5,872
221,180,147,233,653,325,328,1,3,1,ABMrun_3.1.23_b,5,886
222,178,133,226,672,338,334,0,3,1,ABMrun_3.1.23_b,5,898
223,178,142,220,685,339,346,0,3,1,ABMrun_3.1.23_b,5,905
224,174,137,225,672,308,364,1,3,1,ABMrun_3.1.23_b,5,897
225,190,152,236,639,298,341,2,3,1,ABMrun_3.1.23_b,5,875
226,164,134,216,693,332,361,1,3,1,ABMrun_3.1.23_b,5,909
227,167,131,220,683,334,349,1,3,1,ABMrun_3.1.23_b,5,903
228,183,140,225,666,325,341,0,3,1,ABMrun_3.1.23_b,5,891
229,168,136,225,659,320,339,0,3,1,ABMrun_3.1.23_b,5,884
230,178,139,226,673,329,344,0,3,1,ABMrun_3.1.23_b,5,899
231,181,141,229,651,329,322,0,3,1,ABMrun_3.1.23_b,5,880
232,174,142,226,677,349,328,0,3,1,ABMrun_3.1.23_b,5,903
233,182,132,230,665,329,336,1,3,1,ABMrun_3.1.23_b,5,895
234,184,129,233,650,336,314,2,3,1,ABMrun_3.1.23_b,5,883
235,172,140,228,655,330,325,1,3,1,ABMrun_3.1.23_b,5,883
236,167,135,222,677,334,343,0,3,1,ABMrun_3.1.23_b,5,899
237,167,130,222,677,337,340,1,3,1,ABMrun_3.1.23_b,5,899
238,173,138,229,653,322,331,1,3,1,ABMrun_3.1.23_b,5,882
239,176,136,227,657,337,320,1,3,1,ABMrun_3.1.23_b,5,884
240,175,133,228,657,349,308,1,3,1,ABMrun_3.1.23_b,5,885
241,173,136,222,672,351,321,1,3,1,ABMrun_3.1.23_b,5,894
242,179,135,227,659,344,315,1,3,1,ABMrun_3.1.23_b,5,886
243,179,143,227,663,330,333,0,3,1,ABMrun_3.1.23_b,5,890
244,183,138,231,663,333,330,1,3,1,ABMrun_3.1.23_b,5,894
245,188,133,238,617,311,306,0,3,1,ABMrun_3.1.23_b,5,855
246,182,139,234,633,325,308,0,3,1,ABMrun_3.1.23_b,5,867
247,169,131,227,665,344,321,1,3,1,ABMrun_3.1.23_b,5,892
248,170,141,222,671,333,338,1,3,1,ABMrun_3.1.23_b,5,893
249,179,141,224,676,327,349,1,3,1,ABMrun_3.1.23_b,5,900
250,171,134,220,680,314,366,1,3,1,ABMrun_3.1.23_b,5,900
251,158,127,202,733,355,378,0,3,1,ABMrun_3.1.23_b,5,935
252,166,126,221,675,332,343,1,3,1,ABMrun_3.1.23_b,5,896
253,178,122,229,654,343,311,1,3,1,ABMrun_3.1.23_b,5,883
254,195,136,237,628,321,307,1,3,1,ABMrun_3.1.23_b,5,865
255,178,126,227,670,349,321,0,3,1,ABMrun_3.1.23_b,5,897
256,166,126,219,682,362,320,1,3,1,ABMrun_3.1.23_b,5,901
257,179,134,227,669,367,302,1,3,1,ABMrun_3.1.23_b,5,896
258,169,130,214,690,374,316,0,3,1,ABMrun_3.1.23_b,5,904
259,165,127,220,676,353,323,1,3,1,ABMrun_3.1.23_b,5,896
260,174,130,228,653,344,309,2,3,1,ABMrun_3.1.23_b,5,881
261,172,125,225,663,337,326,1,3,1,ABMrun_3.1.23_b,5,888
262,161,127,222,673,332,341,1,3,1,ABMrun_3.1.23_b,5,895
263,162,122,224,667,335,332,2,3,1,ABMrun_3.1.23_b,5,891
264,179,143,226,668,355,313,1,3,1,ABMrun_3.1.23_b,5,894
265,176,131,222,676,361,315,1,3,1,ABMrun_3.1.23_b,5,898
266,177,132,228,658,364,294,1,3,1,ABMrun_3.1.23_b,5,886
267,176,134,225,663,347,316,0,3,1,ABMrun_3.1.23_b,5,888
268,176,140,224,671,332,339,1,3,1,ABMrun_3.1.23_b,5,895
269,171,139,224,664,329,335,1,3,1,ABMrun_3.1.23_b,5,888
270,183,137,232,648,323,325,0,3,1,ABMrun_3.1.23_b,5,880
271,177,147,229,659,318,341,2,3,1,ABMrun_3.1.23_b,5,888
272,179,139,224,673,329,344,1,3,1,ABMrun_3.1.23_b,5,897
273,177,139,224,665,339,326,2,3,1,ABMrun_3.1.23_b,5,889
274,180,135,221,678,334,344,1,3,1,ABMrun_3.1.23_b,5,899
275,170,134,223,667,323,344,1,3,1,ABMrun_3.1.23_b,5,890
276,156,125,200,736,351,385,2,3,1,ABMrun_3.1.23_b,5,936
277,168,128,222,681,334,347,1,3,1,ABMrun_3.1.23_b,5,903
278,169,134,223,672,339,333,1,3,1,ABMrun_3.1.23_b,5,895
279,168,135,225,669,330,339,1,3,1,ABMrun_3.1.23_b,5,894
280,165,127,222,677,354,323,1,3,1,ABMrun_3.1.23_b,5,899
281,166,124,224,668,339,329,1,3,1,ABMrun_3.1.23_b,5,892
282,184,143,224,676,341,335,0,3,1,ABMrun_3.1.23_b,5,900
283,180,133,228,661,330,331,1,3,1,ABMrun_3.1.23_b,5,889
284,171,138,221,679,345,334,0,3,1,ABMrun_3.1.23_b,5,900
285,177,134,230,642,301,341,0,3,1,ABMrun_3.1.23_b,5,872
286,178,138,229,663,313,350,2,3,1,ABMrun_3.1.23_b,5,892
287,167,134,220,686,338,348,2,3,1,ABMrun_3.1.23_b,5,906
288,184,142,230,657,318,339,1,3,1,ABMrun_3.1.23_b,5,887
289,174,134,228,655,303,352,0,3,1,ABMrun_3.1.23_b,5,883
290,173,136,228,656,303,353,1,3,1,ABMrun_3.1.23_b,5,884
291,172,128,230,648,316,332,0,3,1,ABMrun_3.1.23_b,5,878
292,175,138,229,652,322,330,0,3,1,ABMrun_3.1.23_b,5,881
293,176,136,221,678,345,333,2,3,1,ABMrun_3.1.23_b,5,899
294,179,140,220,680,329,351,3,3,1,ABMrun_3.1.23_b,5,900
295,171,134,222,678,327,351,1,3,1,ABMrun_3.1.23_b,5,900
296,162,124,223,671,313,358,1,3,1,ABMrun_3.1.23_b,5,894
297,177,136,223,676,309,367,2,3,1,ABMrun_3.1.23_b,5,899
298,172,138,225,666,328,338,1,3,1,ABMrun_3.1.23_b,5,891
299,185,143,230,647,304,343,0,3,1,ABMrun_3.1.23_b,5,877
300,162,129,218,686,329,357,0,3,1,ABMrun_3.1.23_b,5,904
301,154,123,201,724,341,383,1,3,1,ABMrun_3.1.23_b,5,925
302,176,138,228,659,311,348,2,3,1,ABMrun_3.1.23_b,5,887
303,182,138,229,653,305,348,1,3,1,ABMrun_3.1.23_b,5,882
304,175,131,227,656,321,335,2,3,1,ABMrun_3.1.23_b,5,883
305,175,139,221,687,344,343,2,3,1,ABMrun_3.1.23_b,5,908
306,183,129,233,646,331,315,1,3,1,ABMrun_3.1.23_b,5,879
307,188,143,238,636,329,307,0,3,1,ABMrun_3.1.23_b,5,874
308,178,137,225,670,323,347,1,3,1,ABMrun_3.1.23_b,5,895
309,174,137,225,662,311,351,1,3,1,ABMrun_3.1.23_b,5,887
310,182,139,226,667,315,352,0,3,1,ABMrun_3.1.23_b,5,893
311,179,133,228,668,316,352,0,3,1,ABMrun_3.1.23_b,5,896
312,166,131,222,674,326,348,2,3,1,ABMrun_3.1.23_b,5,896
313,176,135,219,684,337,347,0,3,1,ABMrun_3.1.23_b,5,903
314,166,131,222,677,348,329,1,3,1,ABMrun_3.1.23_b,5,899
315,172,134,220,679,351,328,2,3,1,ABMrun_3.1.23_b,5,899
316,186,144,232,641,328,313,1,3,1,ABMrun_3.1.23_b,5,873
317,177,138,230,650,310,340,0,3,1,ABMrun_3.1.23_b,5,880
318,166,124,213,697,346,351,2,3,1,ABMrun_3.1.23_b,5,910
319,174,133,222,678,342,336,1,3,1,ABMrun_3.1.23_b,5,900
320,174,132,226,665,340,325,1,3,1,ABMrun_3.1.23_b,5,891
321,171,135,225,658,321,337,0,3,1,ABMrun_3.1.23_b,5,883
322,179,133,235,638,315,323,1,3,1,ABMrun_3.1.23_b,5,873
323,174,136,221,674,341,333,1,3,1,ABMrun_3.1.23_b,5,895
324,171,137,220,681,340,341,0,3,1,ABMrun_3.1.23_b,5,901
325,184,143,229,652,331,321,0,3,1,ABMrun_3.1.23_b,5,881
326,172,136,218,696,348,348,1,3,1,ABMrun_3.1.23_b,5,914
327,180,136,227,656,329,327,2,3,1,ABMrun_3.1.23_b,5,883
328,184,145,229,654,330,324,2,3,1,ABMrun_3.1.23_b,5,883
329,186,141,236,633,328,305,0,3,1,ABMrun_3.1.23_b,5,869
330,190,140,232,640,324,316,1,3,1,ABMrun_3.1.23_b,5,872
331,181,147,229,649,328,321,0,3,1,ABMrun_3.1.23_b,5,878
332,178,139,224,667,343,324,2,3,1,ABMrun_3.1.23_b,5,891
333,176,143,221,675,351,324,0,3,1,ABMrun_3.1.23_b,5,896
334,173,143,224,671,330,341,2,3,1,ABMrun_3.1.23_b,5,895
335,174,137,225,669,332,337,1,3,1,ABMrun_3.1.23_b,5,894
336,173,137,224,667,321,346,2,3,1,ABMrun_3.1.23_b,5,891
337,172,135,221,684,320,364,0,3,1,ABMrun_3.1.23_b,5,905
338,179,135,225,669,312,357,0,3,1,ABMrun_3.1.23_b,5,894
339,183,150,234,642,313,329,1,3,1,ABMrun_3.1.23_b,5,876
340,171,128,221,685,351,334,0,3,1,ABMrun_3.1.23_b,5,906
341,177,129,227,667,353,314,1,3,1,ABMrun_3.1.23_b,5,894
342,177,131,226,666,345,321,0,3,1,ABMrun_3.1.23_b,5,892
343,177,146,224,665,337,328,1,3,1,ABMrun_3.1.23_b,5,889
344,167,128,227,659,334,325,1,3,1,ABMrun_3.1.23_b,5,886
345,172,133,227,663,332,331,0,3,1,ABMrun_3.1.23_b,5,890
346,171,135,226,667,321,346,0,3,1,ABMrun_3.1.23_b,5,893
347,175,142,224,667,319,348,1,3,1,ABMrun_3.1.23_b,5,891
348,176,144,218,682,324,358,0,3,1,ABMrun_3.1.23_b,5,900
349,178,144,229,656,321,335,1,3,1,ABMrun_3.1.23_b,5,885
350,179,143,228,655,320,335,1,3,1,ABMrun_3.1.23_b,5,883
